source,end,CON,LAB,LDEM,UKIP,GRN,CON_LEAD
Opinium/Observer,2020-05-07,49,33,6,,5.0,16
Redfield and Wilton/,2020-05-06,50,31,7,,5.0,19
YouGov/Times,2020-05-06,50,30,7,,5.0,20
Opinium/Observer,2020-05-01,51,33,6,,3.0,18
Survation/,2020-04-28,48,31,8,,5.0,17
Redfield and Wilton/,2020-04-26,50,33,7,,4.0,17
Opinium/Observer,2020-04-23,50,33,7,,3.0,17
Kantar/,2020-04-20,54,28,9,,4.0,26
YouGov/Times,2020-04-17,53,32,5,,3.0,21
Opinium/Observer,2020-04-17,51,32,6,,3.0,19
Redfield and Wilton/,2020-04-17,52,31,8,,3.0,21
BMG/Independent,2020-04-09,46,29,10,,6.0,17
Opinium/Observer,2020-04-09,55,29,5,,4.0,26
Opinium/Observer,2020-04-03,53,30,7,,3.0,23
YouGov/Times,2020-04-02,52,28,8,,5.0,24
Redfield and Wilton/,2020-04-02,49,29,8,,4.0,20
Opinium/Observer,2020-03-27,54,28,6,,3.0,26
NCPolitics/Bloomberg,2020-03-26,54,28,7,,4.0,26
Redfield and Wilton/,2020-03-23,47,29,8,,5.0,18
Opinium/Observer,2020-03-20,51,31,7,,3.0,20
Ipsos-MORI/Evening Standard,2020-03-16,52,30,9,,4.0,22
Opinium/Observer,2020-03-13,49,32,6,,5.0,17
Kantar Public/,2020-03-09,50,29,11,,2.0,21
BMG/Independent,2020-03-06,45,28,11,,6.0,17
YouGov/Times,2020-03-02,49,30,8,,5.0,19
SavantaComRes/Sunday Express,2020-02-20,47,31,9,,4.0,16
Opinium/Observer,2020-02-14,47,32,7,,4.0,15
Redfield and Wilton/,2020-02-12,49,31,9,,4.0,18
YouGov/Times,2020-02-10,48,28,10,,6.0,20
BMG/Independent,2020-02-07,41,29,11,,8.0,12
Ipsos-MORI/Evening Standard,2020-02-03,47,30,11,,5.0,17
Survation/,2020-01-31,44,33,10,,3.0,11
YouGov/Times,2020-01-26,49,29,10,,4.0,20
Opinium/Observer,2020-01-17,47,30,9,,4.0,17
BMG/Independent,2020-01-10,44,29,11,,5.0,15
Deltapoll/,2019-12-11,45,35,10,,3.0,10
Kantar/,2019-12-11,44,32,13,,3.0,12
BMG/The Independent,2019-12-11,41,32,14,,3.0,9
Opinium/,2019-12-11,45,33,12,,2.0,12
Panelbase/,2019-12-11,43,34,11,,3.0,9
Survation/,2019-12-11,45,34,9,,3.0,11
Ipsos-MORI/Evening Standard,2019-12-11,44,33,12,,3.0,11
Number Cruncher Politics/Bloomberg,2019-12-10,43,33,12,,3.0,10
YouGov/Times/Sky (MRP),2019-12-10,43,34,12,,3.0,9
SavantaComRes/The Daily Telegraph,2019-12-10,41,36,12,,2.0,5
ICM Research/Reuters,2019-12-09,42,36,12,,2.0,6
Qriously/,2019-12-08,43,30,12,,4.0,13
SavantaComRes/Remain United,2019-12-08,43,36,12,,2.0,7
Survation/Good Morning Britain,2019-12-07,45,31,11,,2.0,14
Deltapoll/The Mail on Sunday,2019-12-07,44,33,11,,2.0,11
Panelbase/,2019-12-06,43,34,13,,2.0,9
Opinium/The Observer,2019-12-06,46,31,13,,2.0,15
BMG/The Independent,2019-12-06,41,32,14,,4.0,9
YouGov/The Sunday Times,2019-12-06,43,33,13,,3.0,10
SavantaComRes/Remain United,2019-12-05,42,36,11,,2.0,6
SavantaComRes/The Sunday Telegraph,2019-12-05,41,33,12,,2.0,8
Ipsos-MORI/Evening Standard,2019-12-04,44,32,13,,3.0,12
YouGov/Times/Sky,2019-12-03,42,33,12,,4.0,9
ComRes/Telegraph,2019-12-03,42,32,12,,2.0,10
Kantar/,2019-12-02,44,32,15,,3.0,12
ICM/Reuters,2019-12-02,42,35,13,,2.0,7
Survation/Good Morning Britain,2019-11-30,42,33,11,,4.0,9
Deltapoll/Mail on Sunday,2019-11-30,45,32,15,,1.0,13
BMG/Independent,2019-11-29,39,33,13,,5.0,6
Opinium/Observer,2019-11-29,46,31,13,,3.0,15
YouGov/Sunday Times,2019-11-29,43,34,13,,3.0,9
Panelbase/,2019-11-28,42,34,13,,3.0,8
SavantaComRes/Sunday Telegraph,2019-11-28,43,33,13,,3.0,10
YouGov/Times/Sky,2019-11-26,43,32,13,,2.0,11
SavantaComRes/Telegraph,2019-11-26,41,34,13,,2.0,7
ICM/Reuters,2019-11-25,41,34,13,,3.0,7
Kantar/,2019-11-25,43,32,14,,4.0,11
Deltapoll/Mail on Sunday,2019-11-23,43,30,16,,3.0,13
Survation/Good Morning Britain,2019-11-23,41,30,15,,3.0,11
Panelbase/,2019-11-22,42,32,14,,3.0,10
Opinium/Observer,2019-11-22,47,28,12,,3.0,19
YouGov/Sunday Times,2019-11-22,42,30,16,,4.0,12
SavantaComRes/Sunday Express,2019-11-21,42,32,15,,2.0,10
BMG/Independent,2019-11-21,41,28,18,,5.0,13
YouGov/Times/Sky,2019-11-20,43,29,15,,3.0,14
Ipsos MORI/Evening Standard,2019-11-19,44,28,16,,3.0,16
YouGov/Times,2019-11-19,42,30,15,,4.0,12
SavantaComRes/Telegraph,2019-11-19,42,31,15,,2.0,11
Kantar/,2019-11-18,45,27,16,,3.0,18
YouGov/Times/Sky,2019-11-18,42,30,15,,4.0,12
ICM/Reuters,2019-11-18,42,32,13,,3.0,10
Deltapoll/Mail on Sunday,2019-11-16,45,30,11,,3.0,15
Survation/GMB,2019-11-16,42,28,13,,3.0,14
BMG/Independent,2019-11-15,37,29,16,,5.0,8
Opinium/Observer,2019-11-15,44,28,14,,3.0,16
YouGov/Sunday Times,2019-11-15,45,28,15,,3.0,17
Panelbase/,2019-11-14,43,30,15,,2.0,13
ComRes/Sunday Telegraph,2019-11-14,41,33,14,,2.0,8
YouGov/Times/Sky,2019-11-12,42,28,15,,4.0,14
ComRes/Telegraph,2019-11-12,40,30,16,,3.0,10
Kantar/,2019-11-11,37,27,17,,3.0,10
ICM/Reuters,2019-11-11,39,31,15,,3.0,8
ComRes/Britain Elects,2019-11-10,37,29,17,,3.0,8
Deltapoll/Mail on Sunday,2019-11-09,41,29,16,,2.0,12
Opinium/Observer,2019-11-08,41,29,15,,2.0,12
Panelbase/,2019-11-08,40,30,15,,3.0,10
YouGov/Sunday Times,2019-11-08,39,26,17,,4.0,13
Survation/,2019-11-08,35,29,17,,1.0,6
BMG/Independent,2019-11-08,37,29,16,,7.0,8
YouGov/Times/Sky,2019-11-06,36,25,17,,5.0,11
ComRes/Remain United,2019-11-05,36,29,17,,3.0,7
YouGov/Times,2019-11-04,38,25,16,,5.0,13
ICM/Reuters,2019-11-04,38,31,15,,3.0,7
Deltapoll/Mail on Sunday,2019-11-02,40,28,14,,2.0,12
Opinium/Observer,2019-11-01,42,26,16,,2.0,16
YouGov/Sunday Times,2019-11-01,39,27,16,,4.0,12
Panelbase/,2019-10-31,40,29,14,,3.0,11
ORB/Sunday Telegraph,2019-10-31,36,28,14,,4.0,8
ComRes/Sunday Express,2019-10-31,36,28,17,,3.0,8
Survation/Daily Mail,2019-10-30,34,26,19,,1.0,8
YouGov/Times,2019-10-30,36,21,18,,6.0,15
Ipsos-MORI/Evening Standard,2019-10-28,41,24,20,,3.0,17
Opinium/Observer,2019-10-25,40,24,15,,3.0,16
YouGov/,2019-10-25,36,23,18,,6.0,13
Deltapoll/,2019-10-21,37,24,19,,3.0,13
YouGov/Times,2019-10-21,37,22,19,,7.0,15
Survation/Daily Mail,2019-10-18,32,24,21,,2.0,8
Panelbase/,2019-10-18,36,27,17,,3.0,9
Opinium/Observer,2019-10-17,37,24,16,,4.0,13
ComRes/Britain Elects,2019-10-17,33,29,18,,4.0,4
Kantar/,2019-10-15,39,25,18,,3.0,14
YouGov/Times,2019-10-15,37,22,18,,5.0,15
Panelbase/Sunday Times,2019-10-11,33,30,17,,3.0,3
ComRes/Express,2019-10-10,33,27,18,,4.0,6
YouGov/Times,2019-10-09,35,22,20,,6.0,13
ICM/Represent Us,2019-10-07,35,29,16,,4.0,6
ComRes/Telegraph,2019-10-06,33,27,19,,3.0,6
Opinium/Observer,2019-10-04,38,23,15,,4.0,15
BMG/Independent,2019-10-04,31,26,20,,7.0,5
YouGov/Times,2019-10-01,34,21,23,,5.0,11
YouGov/Sunday Times,2019-09-27,33,22,21,,5.0,11
Opinium/Observer,2019-09-27,36,24,20,,2.0,12
YouGov/Times,2019-09-25,33,22,22,,6.0,11
Survation/Daily Mail,2019-09-25,27,24,22,,3.0,3
Opinium/Observer,2019-09-20,37,22,17,,4.0,15
YouGov/Peopleâ€™s Vote,2019-09-20,30,23,22,,5.0,7
ComRes/Britain Elects,2019-09-19,29,27,20,,4.0,2
YouGov/Times,2019-09-18,32,21,23,,4.0,9
Ipsos-MORI/Evening Standard,2019-09-16,33,24,23,,4.0,9
Opinium/Observer,2019-09-13,37,25,16,,2.0,12
ComRes/Sunday Express,2019-09-12,28,27,20,,5.0,1
YouGov/Times,2019-09-10,32,23,19,,7.0,9
Kantar/,2019-09-09,38,24,20,,3.0,14
Deltapoll/Sun on Sunday,2019-09-07,31,28,17,,4.0,3
Opinium/Observer,2019-09-06,35,25,17,,3.0,10
ComRes/Britain Elects,2019-09-06,31,27,20,,3.0,4
BMG/Independent,2019-09-06,31,27,19,,,4
YouGov/Sunday Times,2019-09-06,35,21,19,,7.0,14
Panelbase/,2019-09-06,31,28,19,,2.0,3
Survation/Daily Mail,2019-09-06,29,24,18,,3.0,5
ICM/Represent Us,2019-09-03,37,30,16,,4.0,7
YouGov/Times,2019-09-03,35,25,16,,7.0,10
Deltapoll/Mail on Sunday,2019-08-31,35,24,18,,4.0,11
Survation/Daily Mail,2019-08-30,31,24,21,,3.0,7
YouGov/,2019-08-29,33,22,21,,7.0,11
YouGov/Times,2019-08-28,34,22,17,,8.0,12
YouGov/Sunday Times,2019-08-23,33,21,19,,7.0,12
Opinium/Observer,2019-08-23,32,26,15,,4.0,6
YouGov/Times,2019-08-21,32,22,20,,7.0,10
Kantar/,2019-08-19,42,28,15,,3.0,14
YouGov/Times,2019-08-14,30,21,20,,8.0,9
BMG/Independent,2019-08-12,31,25,19,,6.0,6
ComRes/Telegraph,2019-08-11,31,27,16,,4.0,4
Survation/,2019-08-11,28,24,21,,3.0,4
Opinium/Observer,2019-08-09,31,28,13,,5.0,3
ComRes/Telegraph,2019-08-08,30,29,17,,4.0,1
YouGov/Times,2019-08-06,31,22,21,,7.0,9
Ipsos-MORI/Evening Standard,2019-07-30,34,24,20,,6.0,10
YouGov/Times,2019-07-30,32,22,19,,8.0,10
ComRes/Britain Elects,2019-07-28,29,30,16,,5.0,-1
Deltapoll/Mail on Sunday,2019-07-27,30,25,18,,4.0,5
Opinium/Observer,2019-07-26,30,28,16,,5.0,2
YouGov/Sunday Times,2019-07-26,31,21,20,,8.0,10
ComRes/Sunday Express,2019-07-25,28,27,19,,4.0,1
YouGov/Times,2019-07-24,25,19,23,,9.0,6
YouGov/Times,2019-07-17,25,21,20,,8.0,4
ComRes/Britain Elects,2019-07-16,25,28,17,,5.0,-3
Survation/,2019-07-11,23,29,19,,3.0,-6
ComRes/Sunday Express,2019-07-11,24,28,15,,5.0,-4
YouGov/Times,2019-07-10,24,20,19,,9.0,4
ComRes/Telegraph,2019-07-07,25,28,16,,5.0,-3
Opinium/Observer,2019-07-05,23,25,15,1.0,8.0,-2
YouGov/Times,2019-07-03,24,18,20,,9.0,1
YouGov/Times,2019-06-25,22,20,19,1.0,10.0,0
Ipsos-MORI/Evening Standard,2019-06-25,26,24,22,1.0,8.0,2
Opinium/Observer,2019-06-20,20,26,16,2.0,6.0,-3
Survation/Mail on Sunday,2019-06-20,24,26,18,1.0,6.0,-2
YouGov/Times,2019-06-19,20,20,21,1.0,9.0,-2
YouGov/Sunday Times,2019-06-14,21,21,19,,9.0,-3
YouGov/Times,2019-06-10,17,19,22,,8.0,-4
ComRes/Telegraph,2019-06-09,23,27,17,1.0,5.0,-4
BMG/Independent,2019-06-07,26,27,17,1.0,6.0,-1
YouGov/Times,2019-06-06,18,20,20,1.0,9.0,-6
YouGov/,2019-06-05,18,19,22,,9.0,-3
YouGov/,2019-06-01,18,19,23,,10.0,0
Deltapoll/Mail on Sunday,2019-05-30,20,26,16,1.0,5.0,-2
Opinium/Observer,2019-05-30,17,22,16,1.0,11.0,-4
YouGov/Times,2019-05-29,19,19,24,1.0,8.0,-2
Survation/Daily Mail,2019-05-22,28,33,13,3.0,3.0,-5
NCPolitics/,2019-05-21,27,31,15,1.0,4.0,-4
Panelbase/Sunday Times,2019-05-21,21,31,13,3.0,5.0,-10
Opinium/Observer,2019-05-20,22,26,12,2.0,4.0,-1
Survation/Daily Mail,2019-05-17,27,32,13,2.0,3.0,-5
YouGov/Hope Not Hate,2019-05-17,24,24,18,2.0,6.0,0
Opinium/Observer,2019-05-16,22,29,11,2.0,3.0,-5
Ipsos-MORI/Evening Standard,2019-05-14,25,27,15,3.0,7.0,-2
YouGov/Times,2019-05-14,25,25,16,2.0,7.0,0
Hanbury/Politico,2019-05-13,21,30,13,2.0,5.0,-9
Kantar/,2019-05-13,25,34,15,4.0,3.0,-9
ComRes/Telegraph,2019-05-12,20,27,13,4.0,4.0,-7
Opinium/Observer,2019-05-10,22,28,11,4.0,6.0,-6
BMG/Independent,2019-05-10,27,30,18,3.0,6.0,-3
ComRes/Brexit Express,2019-05-09,19,27,14,3.0,5.0,-7
YouGov/Times,2019-05-09,24,24,16,2.0,7.0,0
Opinium/Peoples Vote,2019-05-07,25,30,11,4.0,5.0,-5
YouGov/,2019-04-30,29,29,13,2.0,5.0,0
YouGov/Times,2019-04-24,27,30,11,4.0,5.0,-3
Panelbase/Sunday Times,2019-04-24,27,36,8,5.0,3.0,-9
Opinium/Observer,2019-04-23,26,33,6,4.0,4.0,-7
ORB/Telegraph,2019-04-17,26,29,8,5.0,4.0,-3
YouGov/Times,2019-04-17,29,30,10,4.0,5.0,-1
ComRes/Brexit Express,2019-04-16,23,33,7,5.0,3.0,-10
Opinium/Observer,2019-04-12,29,36,8,11.0,4.0,-7
YouGov/Times,2019-04-11,28,32,11,6.0,5.0,-4
Hanbury/Open Europe,2019-04-08,31,40,8,8.0,5.0,-9
Kantar/,2019-04-08,32,35,11,7.0,4.0,-3
Survation/,2019-04-08,37,41,10,7.0,2.0,-4
ComRes/Telegraph,2019-04-07,32,32,7,9.0,3.0,0
BMG/Independent,2019-04-05,29,31,8,7.0,4.0,-2
YouGov/Times,2019-04-03,32,31,12,7.0,4.0,1
Deltapoll/Mail on Sunday,2019-03-30,32,35,7,6.0,2.0,-3
Opinium/Observer,2019-03-29,35,35,9,9.0,5.0,0
YouGov/Times,2019-03-25,36,33,11,4.0,4.0,3
ComRes/Leave Means Leave,2019-03-24,33,33,8,7.0,3.0,0
Opinium/Observer,2019-03-22,36,35,7,9.0,4.0,1
ComRes/Daily Express,2019-03-21,34,35,8,7.0,4.0,-1
Ipsos-MORI/Evening Standard,2019-03-19,38,34,8,7.0,4.0,4
ComRes/Telegraph,2019-03-17,34,35,8,6.0,3.0,-1
YouGov/Peoples Vote,2019-03-15,35,33,11,5.0,6.0,2
Survation/Daily Mail,2019-03-15,35,39,10,5.0,,-4
YouGov/Times,2019-03-15,35,31,12,6.0,5.0,4
Opinium/Observer,2019-03-15,38,34,8,8.0,3.0,4
Kantar/,2019-03-11,41,31,8,6.0,6.0,10
BMG/,2019-03-08,39,34,12,5.0,4.0,5
ComRes/Brexit Express,2019-03-05,36,34,8,6.0,3.0,2
YouGov/Times,2019-03-04,40,31,11,3.0,4.0,9
Opinium/Observer,2019-03-01,40,34,9,7.0,3.0,6
YouGov/Times,2019-02-23,41,30,10,5.0,4.0,11
Deltapoll/Mail on Sunday,2019-02-23,43,36,6,5.0,3.0,7
Opinium/Observer,2019-02-22,40,32,5,7.0,4.0,8
YouGov/Times,2019-02-19,41,33,10,4.0,4.0,8
Survation/Daily Mail,2019-02-18,40,36,10,5.0,2.0,4
Opinium/Observer,2019-02-15,37,37,8,7.0,4.0,0
Kantar/,2019-02-11,40,35,10,3.0,4.0,5
BMG/,2019-02-08,38,35,13,5.0,5.0,3
Ipsos-MORI/Evening Standard,2019-02-05,38,38,10,4.0,3.0,0
YouGov/Times,2019-02-04,41,34,10,4.0,4.0,7
Opinium/Observer,2019-02-01,41,34,8,7.0,4.0,7
Survation/Daily Mail,2019-01-30,38,39,9,4.0,2.0,-1
Opinium/Peoples Vote,2019-01-25,40,36,7,7.0,4.0,4
ICM/,2019-01-18,39,40,9,5.0,3.0,-1
Opinium/Observer,2019-01-18,37,40,7,7.0,4.0,-3
NCPolitics/,2019-01-17,41,39,8,4.0,2.0,2
ComRes/Sunday Express,2019-01-17,38,37,10,6.0,3.0,1
ComRes/Daily Express,2019-01-15,37,39,8,7.0,3.0,-2
Kantar/,2019-01-14,35,38,9,6.0,4.0,-3
YouGov/Times,2019-01-14,39,34,11,6.0,4.0,5
Survation/Daily Mail,2019-01-11,38,41,10,4.0,2.0,-3
BMG/Independent,2019-01-11,36,36,12,6.0,5.0,0
YouGov/Times,2019-01-07,41,35,11,4.0,3.0,6
YouGov/Peoples Vote,2019-01-04,40,34,10,4.0,4.0,6
Opinium/,2018-12-20,39,39,6,6.0,4.0,0
YouGov/Times,2018-12-17,41,39,7,4.0,3.0,2
YouGov/Peoples Vote,2018-12-14,40,36,10,4.0,3.0,4
Opinium/Observer,2018-12-14,38,39,8,6.0,4.0,-1
Populus/,2018-12-11,37,40,7,6.0,3.0,-3
BMG/,2018-12-07,37,38,12,4.0,4.0,-1
YouGov/Sunday Times,2018-12-07,38,37,10,3.0,4.0,1
Kantar/,2018-12-06,38,38,9,5.0,5.0,0
Ipsos-MORI/Evening Standard,2018-12-05,38,38,9,4.0,5.0,0
YouGov/Times,2018-12-04,40,38,9,4.0,4.0,2
ComRes/Sunday Express,2018-12-02,37,39,9,6.0,3.0,-2
YouGov/Times,2018-11-27,40,35,10,6.0,3.0,5
YouGov/Times,2018-11-19,39,36,8,6.0,4.0,3
ComRes/S Express/S Mirror,2018-11-15,36,40,9,7.0,3.0,-4
Opinium/Observer,2018-11-15,36,39,7,8.0,3.0,-3
Kantar/,2018-11-12,40,39,8,3.0,3.0,1
Panelbase/Constitutional Commission,2018-11-07,40,40,8,5.0,3.0,0
YouGov/Times,2018-11-05,41,37,8,4.0,4.0,4
Survation/Channel 4,2018-11-02,39,40,8,3.0,2.0,-1
YouGov/Times,2018-10-30,41,39,7,5.0,2.0,2
ICM/Guardian,2018-10-28,40,38,9,5.0,3.0,2
Deltapoll/Mirror,2018-10-26,43,40,6,5.0,2.0,3
YouGov/Times,2018-10-23,41,36,8,4.0,4.0,5
Ipsos-MORI/Evening Standard,2018-10-22,39,37,10,5.0,5.0,2
YouGov/Times,2018-10-15,41,36,9,4.0,3.0,5
Kantar/,2018-10-15,41,36,10,3.0,4.0,5
Opinium/Observer,2018-10-12,41,37,8,6.0,3.0,4
Survation/,2018-10-10,40,39,7,6.0,,1
YouGov/Times,2018-10-09,41,37,9,4.0,3.0,4
Opinium/Op,2018-10-05,39,39,7,6.0,3.0,0
BMG/Independent,2018-10-05,38,39,10,4.0,4.0,-1
YouGov/Times,2018-10-01,42,36,9,5.0,2.0,6
BMG/Huffington Post,2018-09-29,35,40,12,5.0,3.0,-5
Opinium/Observer,2018-09-28,39,36,9,6.0,3.0,3
ComRes/Express,2018-09-27,39,40,9,5.0,2.0,-1
YouGov/Times,2018-09-25,42,36,11,4.0,2.0,6
ICM/Guardian,2018-09-24,41,40,9,4.0,3.0,1
BMG/Huffington Post,2018-09-22,38,38,10,5.0,4.0,0
Opinium/Observer,2018-09-20,37,39,9,8.0,2.0,-2
YouGov/Times,2018-09-19,40,36,11,5.0,2.0,4
Ipsos-MORI/Evening Standard,2018-09-18,39,37,13,2.0,5.0,2
YouGov/Times,2018-09-13,40,36,11,4.0,3.0,4
Opinium/Observer,2018-09-13,39,38,7,6.0,3.0,1
Opinium/Observer,2018-09-13,39,38,7,6.0,3.0,1
Kantar/,2018-09-10,40,35,10,5.0,4.0,5
ICM/Guardian,2018-09-09,42,39,8,4.0,3.0,3
Survation/Daily Mail,2018-09-07,38,37,10,4.0,1.0,1
BMG/Independent,2018-09-07,37,38,11,7.0,4.0,-1
YouGov/Times,2018-09-04,39,35,11,5.0,4.0,4
Survation/,2018-09-01,37,41,6,7.0,2.0,-4
YouGov/Times,2018-08-29,39,37,10,5.0,3.0,2
YouGov/Times,2018-08-21,40,37,9,6.0,2.0,3
ICM/Guardian,2018-08-19,40,40,8,6.0,2.0,0
Opinium/Observer,2018-08-17,39,38,7,7.0,3.0,1
Deltapoll/Sun on Sunday,2018-08-16,37,40,8,6.0,5.0,-3
YouGov/Times,2018-08-14,41,38,8,6.0,3.0,3
Kantar/,2018-08-13,40,39,9,4.0,3.0,1
NCPolitics/,2018-08-13,38,40,8,5.0,2.0,-2
BMG/Independent,2018-08-10,37,39,10,5.0,5.0,-2
YouGov/Times,2018-08-09,39,35,10,7.0,3.0,4
ICM/Guardian,2018-08-05,39,40,7,6.0,3.0,-1
YouGov/Times,2018-07-31,38,38,10,6.0,3.0,0
Ipsos-MORI/Evening Standard,2018-07-24,38,38,10,6.0,3.0,0
YouGov/Times,2018-07-23,38,38,10,6.0,3.0,0
ICM/Guardian,2018-07-22,40,41,8,5.0,3.0,-1
YouGov/Times,2018-07-20,38,39,9,6.0,2.0,-1
YouGov/Times,2018-07-17,36,41,9,7.0,2.0,-5
Deltapoll/Sun on Sunday,2018-07-14,37,42,7,6.0,3.0,-5
Opinium/Observer,2018-07-13,36,40,8,8.0,3.0,-4
YouGov/Times,2018-07-11,37,39,10,6.0,3.0,-2
Kantar/,2018-07-09,40,38,9,3.0,3.0,2
ICM/Guardian,2018-07-09,41,39,9,4.0,3.0,2
YouGov/Times,2018-07-09,39,39,9,5.0,3.0,0
Survation/Mail on Sunday,2018-07-07,38,40,10,,,-2
BMG/,2018-07-05,39,37,10,3.0,4.0,2
YouGov/Times,2018-07-04,41,40,9,3.0,2.0,1
Ipsos-MORI/Evening Standard,2018-06-27,41,38,7,4.0,4.0,3
YouGov/Times,2018-06-26,42,37,9,3.0,3.0,5
ICM/Guardian,2018-06-24,41,40,9,3.0,3.0,1
Survation/Good Morning Britain,2018-06-20,41,38,7,3.0,3.0,3
YouGov/Times,2018-06-19,42,40,9,3.0,2.0,2
YouGov/Times,2018-06-12,42,39,8,3.0,2.0,3
ICM/Guardian,2018-06-10,42,40,8,3.0,3.0,2
BMG/Independent,2018-06-08,38,41,11,4.0,2.0,-3
Opinium/Observer,2018-06-07,42,40,7,3.0,2.0,2
YouGov/Times,2018-06-05,44,37,8,3.0,3.0,7
Survation/,2018-06-04,41,40,9,2.0,2.0,1
ICM/Guardian,2018-05-29,43,40,8,3.0,2.0,3
YouGov/Times,2018-05-29,42,39,9,3.0,2.0,3
Ipsos-MORI/Evening Standard,2018-05-22,40,40,7,2.0,5.0,0
YouGov/Times,2018-05-21,42,38,9,2.0,3.0,4
ComRes/Daily Mail,2018-05-17,41,41,7,3.0,3.0,0
Opinium/Observer,2018-05-16,43,39,6,4.0,3.0,4
YouGov/Times,2018-05-14,43,38,9,3.0,3.0,5
ICM/Guardian,2018-05-13,43,40,8,3.0,3.0,3
Survation/,2018-05-10,41,40,8,3.0,2.0,1
YouGov/Times,2018-05-09,43,38,9,2.0,2.0,5
BMG/,2018-05-04,39,39,10,4.0,3.0,0
YouGov/Times,2018-05-01,42,38,7,3.0,3.0,4
ComRes/Express,2018-04-29,40,40,9,5.0,3.0,0
ICM/Guardian,2018-04-29,42,39,8,4.0,3.0,3
YouGov/Times,2018-04-25,43,38,8,3.0,3.0,5
Ipsos-MORI/Evening Standard,2018-04-24,41,40,10,2.0,2.0,1
YouGov/Times,2018-04-17,43,38,8,3.0,3.0,5
Survation/Mail on Sunday,2018-04-14,40,40,9,3.0,1.0,0
BMG/,2018-04-13,39,38,11,3.0,4.0,1
ComRes/Sunday Express,2018-04-12,40,41,7,4.0,2.0,-1
Opinium/Observer,2018-04-12,40,40,7,5.0,2.0,0
YouGov/Times,2018-04-10,40,40,9,4.0,2.0,0
YouGov/Times,2018-04-05,42,41,7,4.0,2.0,1
NCPolitics/,2018-04-05,43,38,8,3.0,3.0,5
YouGov/Times,2018-03-27,43,39,8,3.0,2.0,4
ICM/Guardian,2018-03-18,44,41,8,1.0,2.0,3
BMG/,2018-03-16,38,40,10,4.0,3.0,-2
Opinium/Observer,2018-03-15,42,40,6,4.0,3.0,2
YouGov/Times,2018-03-15,42,39,7,3.0,3.0,3
Survation/GMB,2018-03-08,38,45,9,3.0,2.0,-7
Ipsos-MORI/,2018-03-07,43,42,6,2.0,2.0,1
YouGov/Times,2018-03-06,41,43,7,2.0,2.0,-2
ICM/Guardian,2018-03-04,43,42,7,2.0,3.0,1
YouGov/Times,2018-02-27,41,42,7,3.0,2.0,-1
YouGov/Times,2018-02-20,40,42,8,4.0,2.0,-2
ICM/Guardian,2018-02-19,42,43,7,2.0,3.0,-1
YouGov/Times,2018-02-13,40,41,8,2.0,4.0,-1
Kantar/,2018-02-12,39,39,8,2.0,4.0,0
BMG/,2018-02-09,40,40,8,4.0,5.0,0
Opinium/Observer,2018-02-08,42,39,7,5.0,2.0,3
YouGov/Times,2018-02-06,43,39,8,3.0,3.0,4
ICM/Guardian,2018-02-04,41,40,8,4.0,3.0,1
YouGov/Times,2018-01-29,42,42,6,2.0,3.0,0
Survation/,2018-01-29,40,43,8,3.0,1.0,-3
Ipsos-MORI/Standard,2018-01-23,39,42,9,3.0,2.0,-3
ICM/Guardian,2018-01-19,41,41,7,4.0,3.0,0
YouGov/Times,2018-01-17,41,42,7,3.0,2.0,-1
ICM/Guardian,2018-01-14,40,41,7,4.0,3.0,-1
BMG/,2018-01-12,40,41,8,3.0,2.0,-1
Opinium/Observer,2018-01-12,40,40,6,5.0,3.0,0
YouGov/Times,2018-01-08,40,41,9,3.0,2.0,-1
YouGov/Times,2017-12-20,40,42,7,4.0,1.0,-2
ICM/Sun on Sunday,2017-12-14,41,42,7,4.0,3.0,-1
Opinium/Observer,2017-12-14,39,41,7,6.0,2.0,-2
ICM/Guardian,2017-12-10,42,40,8,5.0,2.0,2
YouGov/Times,2017-12-10,42,41,7,4.0,2.0,1
BMG/Independent,2017-12-08,37,40,9,5.0,3.0,-3
YouGov/Times,2017-12-05,40,41,7,3.0,2.0,-1
ICM/Sun on Sunday,2017-12-01,40,41,8,4.0,3.0,-1
Survation/Mail on Sunday,2017-12-01,38,46,6,4.0,1.0,-8
Ipsos-MORI/Evening Standard,2017-11-28,37,39,9,4.0,4.0,-2
ICM/Guardian,2017-11-26,41,41,7,5.0,3.0,0
YouGov/Times,2017-11-23,39,41,7,4.0,3.0,-2
YouGov/Times,2017-11-20,40,43,7,3.0,2.0,-3
Kantar/,2017-11-20,42,38,9,5.0,3.0,4
Opinium/Observer,2017-11-16,40,42,6,5.0,2.0,-2
ICM/Guardian,2017-11-12,41,41,7,4.0,2.0,0
YouGov/Times,2017-11-08,40,43,6,4.0,2.0,-3
Ipsos-MORI/Evening Standard,2017-11-01,38,40,9,4.0,3.0,-2
YouGov/Times,2017-10-24,41,43,7,3.0,2.0,-2
ICM/Guardian,2017-10-23,42,42,7,3.0,2.0,0
YouGov/Times,2017-10-19,40,42,8,4.0,2.0,-2
YouGov/Times,2017-10-11,39,42,8,4.0,2.0,-3
ICM/Guardian,2017-10-08,41,41,7,4.0,2.0,0
Opinium/Observer,2017-10-06,40,42,5,5.0,2.0,-2
YouGov/Times,2017-10-05,40,42,7,4.0,2.0,-2
Survation/,2017-10-05,38,44,7,4.0,1.0,-6
BMG/Independent,2017-09-29,37,42,10,4.0,3.0,-5
ICM/Guardian,2017-09-24,40,42,8,4.0,2.0,-2
YouGov/Times,2017-09-24,39,43,7,4.0,2.0,-4
Survation/Mail on Sunday,2017-09-22,38,42,8,4.0,2.0,-4
Opinium/Observer,2017-09-22,42,40,6,4.0,2.0,2
Ipsos-MORI/,2017-09-18,40,44,9,2.0,1.0,-4
Opinium/Observer,2017-09-15,41,41,5,5.0,3.0,0
BMG/Independent,2017-09-15,39,38,8,6.0,4.0,1
YouGov/Times,2017-09-13,41,42,7,3.0,2.0,-1
ICM/Guardian,2017-09-10,42,42,7,4.0,3.0,0
Survation/Mail on Sunday,2017-09-01,38,43,7,4.0,,-5
YouGov/Times,2017-08-31,41,42,6,4.0,2.0,-1
ICM/Guardian,2017-08-28,42,42,7,3.0,3.0,0
YouGov/Times,2017-08-22,41,42,8,4.0,1.0,-1
Opinium/Observer,2017-08-18,40,43,6,4.0,2.0,-3
BMG/Independent,2017-08-11,42,39,7,6.0,3.0,3
YouGov/Times,2017-08-01,41,44,7,3.0,2.0,-3
YouGov/Times,2017-07-19,41,43,6,3.0,2.0,-2
Ipsos-MORI/Evening Standard,2017-07-18,41,42,9,3.0,2.0,-1
ICM/Guardian,2017-07-16,42,43,7,3.0,2.0,-1
Survation/Mail on Sunday,2017-07-15,39,42,8,6.0,1.0,-3
Opinium/Observer,2017-07-14,41,43,5,5.0,2.0,-2
YouGov/Times,2017-07-11,40,45,7,2.0,1.0,-5
YouGov/Times,2017-07-06,38,46,6,4.0,1.0,-8
ICM/Guardian,2017-07-03,41,43,7,3.0,3.0,-2
Survation/,2017-06-30,42,41,7,2.0,2.0,1
Opinium/Observer,2017-06-29,39,45,5,5.0,2.0,-6
Panelbase/Sunday Times,2017-06-21,41,46,6,2.0,1.0,-5
Survation/Good Morning Britain,2017-06-17,42,45,6,2.0,1.0,-3
Survation/Mail on Sunday,2017-06-10,39,45,7,3.0,1.0,-6
Panelbase/,2017-06-07,44,36,7,5.0,2.0,8
Kantar/,2017-06-07,43,38,7,4.0,2.0,5
ICM/Guardian,2017-06-07,46,34,7,5.0,2.0,12
YouGov/Times,2017-06-07,42,35,10,5.0,2.0,7
ComRes/Independent,2017-06-07,44,34,9,5.0,2.0,10
Survation/,2017-06-07,41,40,8,2.0,2.0,1
BMG/Herald,2017-06-07,46,33,8,5.0,3.0,13
Ipsos-MORI/Evening Standard,2017-06-07,44,36,7,4.0,2.0,8
Opinium/,2017-06-06,43,36,8,5.0,2.0,7
ICM/Guardian,2017-06-04,45,34,8,5.0,3.0,11
Survation/Good Morning Britain,2017-06-03,41,40,6,3.0,1.0,1
Survation/Mail on Sunday,2017-06-03,40,39,8,5.0,2.0,1
ICM/Sun on Sunday,2017-06-02,45,34,9,5.0,3.0,11
ComRes/Ind on Sun/S. Mirror,2017-06-02,47,35,8,4.0,1.0,12
YouGov/Sunday Times,2017-06-02,42,38,9,4.0,2.0,4
Ipsos-MORI/Evening Standard,2017-06-01,45,40,7,2.0,2.0,5
ORB/Sunday Telegraph,2017-06-01,45,36,8,4.0,2.0,9
Panelbase/,2017-06-01,44,36,7,5.0,2.0,8
YouGov/Times,2017-05-31,42,39,7,4.0,2.0,3
Kantar/,2017-05-30,43,33,11,4.0,3.0,10
ICM/Guardian,2017-05-29,45,33,8,5.0,3.0,12
Survation/Good Morning Britain,2017-05-27,43,37,8,4.0,1.0,6
ICM/Sun on Sunday,2017-05-26,46,32,8,5.0,2.0,14
YouGov/Sunday Times,2017-05-26,43,36,9,4.0,2.0,7
ComRes/Ind on Sun/S. Mirror,2017-05-26,46,34,8,5.0,2.0,12
YouGov/Times,2017-05-25,43,38,10,4.0,1.0,5
ORB/Sunday Telegraph,2017-05-25,44,38,7,5.0,2.0,6
YouGov/Times,2017-05-25,43,38,10,4.0,1.0,5
Opinium/Observer,2017-05-24,45,35,7,5.0,2.0,10
Panelbase/,2017-05-23,48,33,7,4.0,2.0,15
Kantar/,2017-05-22,42,34,9,4.0,4.0,8
ICM/Guardian,2017-05-21,47,33,9,4.0,2.0,14
Survation/Mail on Sunday,2017-05-20,46,34,8,3.0,1.0,12
Survation/Good Morning Britain,2017-05-20,43,34,8,4.0,2.0,9
YouGov/Sunday Times,2017-05-19,44,35,9,3.0,2.0,9
ORB/Sunday Telegraph,2017-05-18,46,34,7,7.0,2.0,12
Ipsos-MORI/Evening Standard,2017-05-17,49,34,7,2.0,3.0,15
YouGov/Times,2017-05-17,45,32,8,6.0,2.0,13
Opinium/Observer,2017-05-17,46,33,8,5.0,2.0,13
Panelbase/,2017-05-15,47,33,7,5.0,3.0,14
Kantar/,2017-05-15,47,29,8,6.0,4.0,18
YouGov/Times,2017-05-10,46,30,11,5.0,2.0,16
YouGov/Sunday Times,2017-05-12,49,31,9,3.0,2.0,18
ICM/Guardian,2017-05-14,48,28,10,6.0,3.0,20
ORB/Sunday Telegraph,2017-05-11,46,32,8,7.0,2.0,14
Panelbase/,2017-05-09,48,31,8,5.0,2.0,17
ComRes/Ind on Sun/S. Mirror,2017-05-12,48,30,10,5.0,3.0,18
Survation/Good Morning Britain,2017-05-13,48,30,8,4.0,2.0,18
Opinium/Observer,2017-05-12,47,32,8,5.0,2.0,15
Kantar/,2017-05-08,44,28,11,8.0,6.0,16
ICM/Guardian,2017-05-07,49,27,9,6.0,3.0,22
Survation/Good Morning Britain,2017-05-06,47,30,7,4.0,3.0,17
YouGov/Sunday Times,2017-05-05,47,28,11,6.0,2.0,19
ICM/Sun on Sunday,2017-05-05,46,28,10,8.0,4.0,18
ORB/Sunday Telegraph,2017-05-04,46,31,9,8.0,3.0,15
Opinium/,2017-05-03,46,30,9,7.0,2.0,16
YouGov/Times,2017-05-03,48,29,10,5.0,2.0,19
Kantar/,2017-05-02,48,24,11,7.0,4.0,24
ICM/Guardian,2017-05-02,47,28,8,8.0,4.0,19
Panelbase/,2017-05-02,47,30,10,5.0,2.0,17
Opinium/Observer,2017-04-28,47,30,8,7.0,3.0,17
ICM/Sun on Sunday,2017-04-28,47,28,9,8.0,4.0,19
YouGov/Sunday Times,2017-04-28,44,31,11,6.0,2.0,13
ORB/Sunday Telegraph,2017-04-27,42,31,10,8.0,4.0,11
YouGov/Times,2017-04-26,45,29,10,7.0,3.0,16
Ipsos-MORI/Evening Standard,2017-04-25,49,26,13,4.0,1.0,23
Panelbase/,2017-04-24,49,27,10,5.0,3.0,22
ICM/Guardian,2017-04-24,48,27,10,7.0,3.0,21
Kantar/,2017-04-24,46,24,11,8.0,4.0,22
Survation/Mail on Sunday,2017-04-22,40,29,11,11.0,2.0,11
ICM/ITV,2017-04-21,48,26,10,8.0,3.0,22
YouGov/Sunday Times,2017-04-21,48,25,12,5.0,3.0,23
ComRes/Sunday Mirror,2017-04-20,50,25,11,7.0,3.0,25
Opinium/Observer,2017-04-20,45,26,11,9.0,3.0,19
YouGov/Times,2017-04-19,48,24,12,7.0,2.0,24
ICM/Guardian,2017-04-18,46,25,11,8.0,4.0,21
ICM/Guardian,2017-04-17,44,26,12,11.0,4.0,18
Opinium/Observer,2017-04-13,38,29,7,14.0,5.0,9
ComRes/Independent/S. Mirror,2017-04-13,46,25,11,9.0,4.0,21
YouGov/Times,2017-04-13,44,23,12,10.0,4.0,21
YouGov/Times,2017-04-06,42,25,11,11.0,3.0,17
ICM/Guardian,2017-04-02,43,25,11,11.0,4.0,18
YouGov/Times,2017-03-27,43,25,11,10.0,3.0,18
YouGov/Times,2017-03-21,41,25,11,12.0,3.0,16
ICM/Guardian,2017-03-19,45,26,9,10.0,4.0,19
ComRes/Independent/S. Mirror,2017-03-17,42,25,12,10.0,4.0,17
Opinium/Observer,2017-03-17,41,28,8,13.0,3.0,13
GfK/,2017-03-15,41,28,7,12.0,6.0,13
YouGov/Times,2017-03-14,44,27,10,9.0,4.0,17
Ipsos-MORI/Evening Standard,2017-03-14,43,30,13,6.0,4.0,13
YouGov/Times,2017-03-09,44,25,10,11.0,3.0,19
ICM/Guardian,2017-03-05,44,28,8,11.0,5.0,16
YouGov/Times,2017-02-28,42,25,11,12.0,4.0,17
YouGov/Times,2017-02-22,41,25,11,13.0,3.0,16
ICM/Guardian,2017-02-19,44,26,8,13.0,4.0,18
Opinium/Observer,2017-02-16,40,27,8,14.0,4.0,13
Ipsos-MORI/Evening Standard,2017-02-14,40,29,13,9.0,4.0,11
YouGov/Times,2017-02-13,40,24,11,15.0,4.0,16
ComRes/Independent/S. Mirror,2017-02-10,41,26,11,11.0,4.0,15
YouGov/Times,2017-02-06,40,24,11,14.0,4.0,16
ICM/Guardian,2017-02-05,42,27,10,12.0,4.0,15
Opinium/Observer,2017-02-01,37,30,8,14.0,5.0,7
YouGov/Times,2017-01-31,40,26,11,12.0,4.0,14
YouGov/Times,2017-01-24,40,24,10,14.0,3.0,16
ICM/Guardian,2017-01-22,42,26,10,13.0,5.0,16
YouGov/Times,2017-01-17,42,25,11,12.0,3.0,17
Ipsos-MORI/Evening Standard,2017-01-16,43,31,11,6.0,4.0,12
Survation/Mail on Sunday,2017-01-13,38,29,10,13.0,2.0,9
Opinium/Observer,2017-01-12,38,30,7,14.0,4.0,8
ICM/Guardian,2017-01-08,42,28,9,12.0,4.0,14
YouGov/Times,2017-01-04,39,26,10,14.0,4.0,13
YouGov/Times,2016-12-19,39,24,12,14.0,4.0,15
Opinium/Observer,2016-12-16,38,31,6,13.0,4.0,7
Ipsos-MORI/Evening Standard,2016-12-12,40,29,14,9.0,3.0,11
ICM/Guardian,2016-12-11,41,27,9,14.0,3.0,14
YouGov/Times,2016-12-05,42,25,11,12.0,4.0,17
YouGov/Times,2016-11-29,39,27,9,14.0,4.0,12
ICM/Guardian,2016-11-27,44,28,7,12.0,4.0,16
YouGov/Times,2016-11-22,41,28,9,12.0,4.0,13
ICM/Guardian,2016-11-20,42,28,9,11.0,3.0,14
Opinium/,2016-11-18,41,29,7,12.0,3.0,12
YouGov/Times,2016-11-15,42,28,8,11.0,4.0,14
Ipsos-MORI/Evening Standard,2016-11-14,42,33,10,7.0,3.0,9
Opinium/,2016-11-04,40,32,6,13.0,4.0,8
YouGov/Times,2016-11-01,41,27,10,11.0,4.0,14
ICM/Guardian,2016-10-30,43,27,8,12.0,5.0,16
YouGov/Times,2016-10-25,40,27,11,11.0,3.0,13
BMG/,2016-10-24,42,28,8,12.0,4.0,14
Opinium/Observer,2016-10-21,39,30,6,13.0,4.0,9
YouGov/Election Data,2016-10-20,42,26,8,12.0,5.0,16
Ipsos-MORI/Evening Standard,2016-10-17,47,29,7,6.0,4.0,18
YouGov/Times,2016-10-12,42,28,9,11.0,3.0,14
ICM/Guardian,2016-10-09,43,26,8,11.0,6.0,17
YouGov/Times,2016-09-29,39,30,8,13.0,3.0,9
ICM/Sun on Sunday,2016-09-23,41,26,8,14.0,4.0,15
BMG/,2016-09-23,39,28,8,13.0,5.0,11
YouGov/Times,2016-09-21,39,30,8,13.0,3.0,9
Ipsos-MORI/Evening Standard,2016-09-14,40,34,6,9.0,5.0,6
YouGov/Times,2016-09-14,38,31,7,13.0,4.0,7
ICM/Guardian,2016-09-11,41,27,8,14.0,4.0,14
YouGov/Times,2016-09-05,40,29,7,13.0,3.0,11
YouGov/Times,2016-08-31,38,30,7,14.0,4.0,8
ICM/Guardian,2016-08-28,41,27,9,13.0,4.0,14
YouGov/Times,2016-08-23,40,29,8,13.0,3.0,11
Ashcroft/,2016-08-22,40,31,7,13.0,3.0,9
YouGov/Times,2016-08-17,38,30,9,13.0,4.0,8
Ipsos-MORI/Evening Standard,2016-08-15,45,34,7,6.0,4.0,11
ICM/,2016-08-15,40,28,8,14.0,4.0,12
YouGov/Times,2016-08-08,38,31,8,13.0,4.0,7
TNS BMRB/,2016-08-08,39,26,10,11.0,7.0,13
YouGov/Times,2016-08-02,42,28,8,12.0,3.0,14
YouGov/Times,2016-07-26,40,28,8,13.0,4.0,12
ICM/,2016-07-24,43,27,8,13.0,4.0,16
Opinium/Observer,2016-07-22,37,31,6,15.0,4.0,6
YouGov/,2016-07-18,40,29,9,12.0,3.0,11
ICM/,2016-07-15,39,29,9,14.0,4.0,10
Ipsos-MORI/Evening Standard,2016-07-11,36,35,11,8.0,4.0,1
ICM/,2016-07-10,38,30,8,15.0,4.0,8
Survation/CRC,2016-07-05,36,32,9,12.0,4.0,4
ICM/,2016-07-03,37,30,8,15.0,4.0,7
Opinium/,2016-06-30,34,29,7,17.0,4.0,5
ICM/Guardian,2016-06-26,36,32,7,15.0,5.0,4
Survation/Mail on Sunday,2016-06-25,32,32,9,16.0,4.0,0
Opinium/,2016-06-22,34,30,6,19.0,4.0,4
Opinium/Observer,2016-06-17,34,30,6,18.0,4.0,4
ComRes/Sunday Mirror/Independent (O),2016-06-16,34,29,8,19.0,4.0,5
Ipsos-MORI/Evening Standard,2016-06-14,35,34,9,10.0,4.0,1
ICM/Guardian (O),2016-06-13,34,30,8,19.0,4.0,4
ICM/Guardian (P),2016-06-13,34,33,9,14.0,5.0,1
Opinium/Observer,2016-06-10,35,32,4,18.0,4.0,3
Opinium/Observer,2016-06-03,34,30,6,18.0,4.0,4
ICM/Guardian,2016-05-29,36,32,7,15.0,3.0,4
ICM/Guardian (O),2016-05-29,36,31,7,17.0,4.0,5
Opinium/Observer,2016-05-19,35,30,5,18.0,5.0,5
Ipsos-MORI/Evening Standard,2016-05-16,36,34,8,10.0,5.0,2
ICM/Guardian (O),2016-05-15,34,32,7,17.0,4.0,2
ICM/Guardian,2016-05-15,36,34,7,13.0,4.0,2
ComRes/Independent/S Mirror (O),2016-05-12,36,30,8,17.0,4.0,6
Opinium/Observer,2016-04-29,38,30,5,15.0,5.0,8
BMG/,2016-04-26,33,32,6,18.0,4.0,1
YouGov/Times,2016-04-26,30,33,6,20.0,3.0,-3
Ipsos-MORI/Evening Standard,2016-04-18,38,35,6,11.0,3.0,3
ICM/Guardian (O),2016-04-17,36,31,7,16.0,4.0,5
ICM/Guardian,2016-04-17,38,33,7,13.0,3.0,5
ComRes/Independent/S Mirror (O),2016-04-14,35,30,8,16.0,4.0,5
YouGov/Times,2016-04-12,31,34,8,17.0,3.0,-3
Opinium/Observer,2016-04-01,33,32,5,17.0,4.0,1
BMG/,2016-03-29,36,31,7,16.0,5.0,5
Ipsos-MORI/Evening Standard,2016-03-22,36,34,10,11.0,3.0,2
ComRes/Daily Mail,2016-03-20,37,35,7,9.0,4.0,2
YouGov/Times,2016-03-17,33,34,6,16.0,3.0,-1
ICM/Guardian,2016-03-13,36,36,8,11.0,3.0,0
ComRes/Independent on Sunday (O),2016-03-10,38,29,7,16.0,4.0,9
BMG/,2016-02-23,38,30,5,16.0,5.0,8
YouGov/Times,2016-02-23,37,30,8,16.0,3.0,7
ComRes/Daily Mail,2016-02-22,38,31,8,12.0,3.0,7
Ipsos-MORI/,2016-02-16,39,33,6,12.0,3.0,6
ICM/Guardian,2016-02-14,39,32,7,11.0,4.0,7
ComRes/Independent on Sunday (O),2016-02-12,41,27,9,15.0,3.0,14
YouGov/Times,2016-02-04,39,29,6,18.0,3.0,10
YouGov/,2016-01-28,39,30,6,17.0,3.0,9
Ipsos-MORI/,2016-01-25,40,31,7,11.0,4.0,9
ComRes/Daily Mail,2016-01-24,37,32,6,12.0,4.0,5
ICM/Guardian,2016-01-17,40,35,6,10.0,3.0,5
Survation/Mail on Sunday,2016-01-16,37,30,7,16.0,3.0,7
ComRes/Ind on Sun/S. Mirror,2016-01-15,40,29,7,16.0,3.0,11
Panelbase/Sunday Times,2016-01-14,39,31,6,14.0,3.0,8
ICM/Guardian,2015-12-20,39,34,7,10.0,3.0,5
YouGov/Times,2015-12-18,39,29,6,17.0,3.0,10
Opinium/Observer,2015-12-18,38,30,5,16.0,5.0,8
Ipsos-MORI/Evening Standard,2015-12-14,38,31,9,9.0,6.0,7
ComRes/Daily Mail,2015-12-13,37,33,7,11.0,5.0,4
ComRes/Independent on Sunday (O),2015-12-11,40,29,7,16.0,3.0,11
YouGov/Times,2015-12-01,41,30,6,16.0,3.0,11
YouGov/,2015-11-24,38,29,6,17.0,3.0,9
ComRes/Daily Mail,2015-11-22,40,29,8,11.0,3.0,11
ComRes/Independent on Sunday (O),2015-11-20,42,27,7,15.0,3.0,15
Ipsos-MORI/Evening Standard,2015-11-17,41,34,7,7.0,4.0,7
Survation/Leave.EU,2015-11-17,37,30,6,16.0,3.0,7
ICM/Guardian,2015-11-15,39,33,7,12.0,3.0,6
Survation/Leave.EU,2015-11-11,36,30,7,15.0,3.0,6
BMG/,2015-10-27,37,31,6,15.0,5.0,6
ComRes/Mail,2015-10-25,38,33,8,10.0,3.0,5
Ipsos-MORI/Evening Standard,2015-10-19,36,32,10,12.0,3.0,4
Opinium/,2015-10-16,37,32,5,15.0,4.0,5
ComRes/Independent on Sunday (O),2015-10-15,42,29,7,13.0,3.0,13
ICM/Guardian,2015-10-11,38,34,7,11.0,3.0,4
YouGov/Sun,2015-09-30,37,31,7,17.0,2.0,6
ComRes/DailyMail,2015-09-28,39,30,9,12.0,4.0,9
Ipsos-MORI/Evening Standard,2015-09-23,39,34,9,7.0,4.0,5
YouGov/Sunday Times,2015-09-18,39,31,6,16.0,3.0,8
Opinium/,2015-09-18,37,32,6,14.0,4.0,5
ComRes/Independent on Sunday (O),2015-09-17,42,30,7,13.0,3.0,12
ICM/Guardian,2015-09-13,38,32,8,13.0,3.0,6
Survation/Mail on Sunday,2015-09-04,38,32,6,13.0,4.0,6
ComRes/Daily Mail,2015-08-23,42,28,8,9.0,6.0,14
Survation/TSSA,2015-08-13,38,33,6,15.0,3.0,5
ComRes/Independent on Sunday (O),2015-08-13,40,29,8,13.0,4.0,11
ICM/Guardian,2015-08-09,40,31,7,10.0,4.0,9
ComRes/Daily Mail,2015-07-26,40,28,7,10.0,5.0,12
Ipsos-MORI/Evening Standard,2015-07-20,37,31,10,9.0,8.0,6
ICM/Guardian,2015-07-12,38,34,6,13.0,4.0,4
ComRes/Daily Mail,2015-06-28,39,27,9,11.0,6.0,12
Ipsos-MORI/Evening Standard,2015-06-16,39,30,9,8.0,6.0,9
ICM/Guardian,2015-06-14,37,31,8,13.0,5.0,6
ComRes/Daily Mail,2015-05-31,41,29,8,10.0,5.0,12
YouGov/Sun,2015-05-26,41,30,7,13.0,4.0,11
Survation/Mail on Sunday,2015-05-09,40,31,6,12.0,3.0,9
YouGov/Sun,2015-05-06,34,34,10,12.0,4.0,0
ICM/Guardian,2015-05-06,34,35,9,11.0,4.0,-1
ComRes/Daily Mail,2015-05-06,35,34,9,12.0,4.0,1
Survation/Mirror,2015-05-06,31,31,10,16.0,5.0,0
Panelbase/,2015-05-06,31,33,8,16.0,5.0,-2
Ashcroft/,2015-05-06,33,33,10,11.0,6.0,0
Populus/,2015-05-06,34,34,9,13.0,5.0,0
Ipsos-MORI/Evening Standard,2015-05-06,36,35,8,11.0,5.0,1
BMG/M2015,2015-05-05,34,34,10,12.0,4.0,0
ComRes/Daily Mail,2015-05-05,35,32,9,14.0,4.0,3
YouGov/Sun,2015-05-05,34,34,9,12.0,5.0,0
Opinium/,2015-05-05,35,34,8,12.0,6.0,1
Survation/Mirror,2015-05-05,33,34,9,16.0,4.0,-1
YouGov/Sun,2015-05-04,33,33,10,12.0,5.0,0
YouGov/Sun,2015-05-03,34,33,9,12.0,5.0,1
Ashcroft/,2015-05-03,32,30,11,12.0,7.0,2
Populus/,2015-05-03,34,34,10,13.0,5.0,0
YouGov/Sunday Times,2015-05-02,34,33,8,13.0,5.0,1
Survation/Mail on Sunday,2015-05-02,31,34,8,17.0,4.0,-3
Survation/Mirror,2015-05-01,33,34,9,16.0,3.0,-1
YouGov/Sun,2015-05-01,33,34,8,14.0,5.0,-1
YouGov/Sun,2015-04-30,34,35,8,12.0,5.0,-1
Populus/,2015-04-30,33,33,9,15.0,4.0,0
Panelbase/,2015-04-30,32,34,8,17.0,4.0,-2
YouGov/Sun on Sunday,2015-04-30,34,35,9,12.0,5.0,-1
Ipsos-MORI/Evening Standard,2015-04-29,35,30,8,10.0,8.0,5
YouGov/Sun,2015-04-29,35,34,9,12.0,4.0,1
ComRes/ITV/Mail,2015-04-28,35,35,7,11.0,6.0,0
YouGov/Sun,2015-04-28,34,35,9,12.0,4.0,-1
TNS BMRB/,2015-04-27,34,33,7,15.0,5.0,1
BMG/M2015,2015-04-27,35,32,11,14.0,3.0,3
YouGov/Sun,2015-04-27,35,34,9,12.0,5.0,1
Ashcroft/,2015-04-26,36,30,9,11.0,7.0,6
Populus/,2015-04-26,33,36,8,14.0,5.0,-3
ICM/Guardian,2015-04-26,35,32,9,13.0,5.0,3
YouGov/Sun,2015-04-26,33,34,8,14.0,5.0,-1
YouGov/Sunday Times,2015-04-25,32,34,9,14.0,6.0,-2
Survation/Mail on Sunday,2015-04-25,33,30,9,18.0,4.0,3
YouGov/Sun,2015-04-24,33,35,8,13.0,6.0,-2
Opinium/Observer,2015-04-24,34,33,9,13.0,6.0,1
Survation/Mirror,2015-04-23,33,29,10,18.0,4.0,4
Panelbase/,2015-04-23,31,34,7,17.0,4.0,-3
YouGov/Sun,2015-04-23,33,35,8,13.0,6.0,-2
Populus/,2015-04-23,32,35,8,14.0,5.0,-3
ComRes/ITV/Mail,2015-04-22,36,32,8,10.0,5.0,4
YouGov/Sun,2015-04-22,33,34,7,14.0,5.0,-1
YouGov/Sun,2015-04-21,35,34,7,13.0,5.0,1
YouGov/Sun,2015-04-20,34,35,7,13.0,5.0,-1
TNS BMRB/,2015-04-20,32,34,8,15.0,5.0,-2
ICM/Guardian,2015-04-19,34,32,10,11.0,5.0,2
Populus/,2015-04-19,32,34,9,15.0,4.0,-2
Ashcroft/,2015-04-19,34,30,10,13.0,4.0,4
YouGov/Sun,2015-04-19,34,35,8,13.0,5.0,-1
YouGov/Sunday Times,2015-04-18,33,36,8,13.0,5.0,-3
Opinium/Observer,2015-04-17,36,32,8,13.0,5.0,4
YouGov/Sun,2015-04-17,34,34,9,14.0,5.0,0
Survation/Mirror,2015-04-17,34,33,7,17.0,3.0,1
Populus/,2015-04-16,33,34,9,14.0,4.0,-1
YouGov/Sun,2015-04-16,34,34,7,14.0,5.0,0
Panelbase/,2015-04-16,33,34,8,16.0,4.0,-1
Ipsos-MORI/Evening Standard,2015-04-15,33,35,7,10.0,8.0,-2
YouGov/Sun,2015-04-15,34,35,8,13.0,5.0,-1
YouGov/Sun,2015-04-14,33,35,8,13.0,5.0,-2
TNS BMRB/,2015-04-13,34,32,9,14.0,5.0,2
YouGov/Sun,2015-04-13,33,34,8,13.0,6.0,-1
Populus/,2015-04-12,33,33,8,15.0,5.0,0
ICM/Guardian,2015-04-12,39,33,8,7.0,7.0,6
Ashcroft/,2015-04-12,33,33,9,13.0,6.0,0
YouGov/Sun,2015-04-12,33,36,7,13.0,5.0,-3
YouGov/Sunday Times,2015-04-11,34,34,7,13.0,6.0,0
YouGov/Sun,2015-04-10,33,35,8,13.0,5.0,-2
Survation/Mirror,2015-04-09,31,35,9,15.0,4.0,-4
Opinium/Observer,2015-04-09,36,34,7,11.0,6.0,2
Panelbase/,2015-04-09,31,37,8,16.0,4.0,-6
YouGov/Sun,2015-04-09,35,34,8,12.0,4.0,1
Populus/,2015-04-09,31,33,8,16.0,6.0,-2
YouGov/Sun,2015-04-08,34,35,8,13.0,5.0,-1
ComRes/ITV/Mail,2015-04-08,34,33,12,12.0,4.0,1
TNS BMRB/,2015-04-07,30,33,8,19.0,4.0,-3
YouGov/Sun,2015-04-07,33,35,8,14.0,5.0,-2
Populus/,2015-04-06,31,33,10,15.0,4.0,-2
YouGov/Sunday Times,2015-04-04,34,33,10,13.0,4.0,1
Opinium/Observer,2015-04-03,33,33,7,14.0,7.0,0
Survation/Mirror,2015-04-03,31,33,9,18.0,3.0,-2
Panelbase/,2015-04-02,33,33,7,17.0,5.0,0
YouGov/Sun,2015-04-02,37,35,7,12.0,5.0,2
YouGov/Sun,2015-04-01,36,34,8,13.0,4.0,2
Populus/,2015-04-01,32,34,9,15.0,5.0,-2
YouGov/Sun,2015-03-31,35,36,7,12.0,5.0,-1
YouGov/Sun,2015-03-30,35,35,8,12.0,5.0,0
TNS BMRB/,2015-03-30,33,32,8,16.0,5.0,1
Populus/,2015-03-29,34,34,8,15.0,4.0,0
Ashcroft/,2015-03-29,36,34,6,10.0,7.0,2
ComRes/ITV/Mail,2015-03-29,36,32,9,12.0,5.0,4
YouGov/Sunday Times,2015-03-28,32,36,8,13.0,6.0,-4
Populus/,2015-03-26,31,33,9,16.0,5.0,-2
YouGov/Sun,2015-03-26,36,34,7,13.0,5.0,2
Panelbase/,2015-03-26,34,34,5,15.0,6.0,0
Opinium/Observer,2015-03-25,34,33,8,13.0,7.0,1
YouGov/Sun,2015-03-25,34,35,8,12.0,6.0,-1
Survation/Daily Mirror,2015-03-25,32,33,8,18.0,4.0,-1
YouGov/Sun,2015-03-24,35,35,8,12.0,6.0,0
YouGov/Sun,2015-03-23,34,34,8,12.0,6.0,0
YouGov/Times,2015-03-23,34,33,8,14.0,5.0,1
ComRes/Daily Mail,2015-03-22,35,35,8,10.0,7.0,0
Ashcroft/,2015-03-22,33,33,8,12.0,5.0,0
Populus/,2015-03-22,31,33,9,16.0,5.0,-2
Survation/Mail on Sunday,2015-03-21,30,34,10,17.0,3.0,-4
YouGov/Sunday Times,2015-03-20,33,35,8,14.0,5.0,-2
Opinium/Observer,2015-03-19,36,33,7,14.0,6.0,3
Populus/,2015-03-19,31,34,9,17.0,5.0,-3
YouGov/Sun,2015-03-19,35,33,8,13.0,6.0,2
YouGov/Sun,2015-03-18,33,34,8,14.0,6.0,-1
YouGov/Sun,2015-03-17,34,36,7,12.0,6.0,-2
TNS BMRB/,2015-03-16,33,32,7,17.0,4.0,1
YouGov/Sun,2015-03-16,33,35,7,13.0,7.0,-2
Ashcroft/,2015-03-15,31,29,8,15.0,8.0,2
Populus/,2015-03-15,34,34,8,14.0,5.0,0
ICM/Guardian,2015-03-15,36,35,8,9.0,4.0,1
ComRes/Independent on Sunday (O),2015-03-13,33,35,7,16.0,4.0,-2
YouGov/Sunday Times,2015-03-13,34,34,7,14.0,5.0,0
Opinium/Observer,2015-03-12,33,35,7,14.0,7.0,-2
Populus/,2015-03-12,29,32,8,18.0,6.0,-3
YouGov/Sun,2015-03-12,33,32,7,16.0,6.0,1
Ipsos-MORI/Evening Standard,2015-03-11,33,34,8,13.0,6.0,-1
YouGov/Sun,2015-03-11,34,35,7,14.0,5.0,-1
YouGov/Sun,2015-03-10,33,31,8,15.0,6.0,2
YouGov/Sun,2015-03-09,35,31,8,14.0,6.0,4
Ashcroft/,2015-03-08,34,30,5,15.0,8.0,4
Populus/,2015-03-08,32,33,9,15.0,6.0,-1
Opinium/Observer,2015-03-06,34,34,8,14.0,7.0,0
YouGov/Sunday Times,2015-03-06,34,33,8,15.0,5.0,1
Populus/,2015-03-05,31,33,8,16.0,5.0,-2
YouGov/Sun,2015-03-05,31,35,6,15.0,8.0,-4
YouGov/Sun,2015-03-04,34,34,8,14.0,6.0,0
YouGov/Sun,2015-03-03,36,34,5,14.0,6.0,2
YouGov/Sun,2015-03-02,35,32,7,15.0,6.0,3
Ashcroft/,2015-03-01,34,31,7,14.0,7.0,3
Populus/,2015-03-01,32,34,8,14.0,5.0,-2
YouGov/Sunday Times,2015-02-27,34,34,8,14.0,5.0,0
Populus/,2015-02-27,31,33,9,16.0,6.0,-2
Opinium/Observer,2015-02-26,34,35,6,14.0,6.0,-1
YouGov/Sun,2015-02-26,33,34,8,13.0,6.0,-1
YouGov/Sun,2015-02-25,33,33,8,15.0,6.0,0
YouGov/Sun,2015-02-24,35,33,6,14.0,7.0,2
YouGov/Sun,2015-02-23,33,33,8,13.0,7.0,0
ComRes/Mail,2015-02-23,34,32,8,13.0,8.0,2
Survation/Mirror,2015-02-23,28,34,10,19.0,4.0,-6
Ashcroft/,2015-02-22,32,36,7,11.0,8.0,-4
Populus/,2015-02-22,32,32,9,15.0,6.0,0
Opinium/Observer,2015-02-20,35,33,6,15.0,7.0,2
YouGov/Sunday Times,2015-02-20,33,34,8,13.0,6.0,-1
Populus/,2015-02-19,31,32,9,17.0,6.0,-1
YouGov/Sun,2015-02-19,32,33,9,15.0,6.0,-1
YouGov/Sun,2015-02-18,32,34,8,14.0,6.0,-2
YouGov/Sun,2015-02-17,33,34,6,15.0,7.0,-1
YouGov/Sun,2015-02-16,32,32,6,16.0,8.0,0
TNS BMRB/,2015-02-16,28,35,6,18.0,7.0,-7
Ashcroft/,2015-02-15,30,31,9,16.0,8.0,-1
ICM/Guardian,2015-02-15,36,32,10,9.0,7.0,4
Populus/,2015-02-14,31,33,10,15.0,5.0,-2
YouGov/Sunday Times,2015-02-13,32,35,7,15.0,7.0,-3
Populus/,2015-02-12,31,34,9,14.0,6.0,-3
ComRes/Independent on Sunday (O),2015-02-12,32,34,7,16.0,4.0,-2
Opinium/Observer,2015-02-12,33,35,8,14.0,6.0,-2
YouGov/Sun,2015-02-12,31,34,7,15.0,7.0,-3
YouGov/Sun,2015-02-11,32,33,7,15.0,7.0,-1
Ipsos-MORI/Evening Standard,2015-02-10,34,36,6,9.0,7.0,-2
YouGov/Sun,2015-02-10,33,35,6,13.0,8.0,-2
YouGov/Sun,2015-02-09,34,33,7,14.0,7.0,1
Populus/,2015-02-08,33,34,8,15.0,4.0,-1
Ashcroft/,2015-02-08,34,31,9,14.0,6.0,3
Opinium/Observer,2015-02-06,32,34,7,15.0,8.0,-2
YouGov/Sunday Times,2015-02-06,32,33,7,15.0,8.0,-1
Populus/,2015-02-05,31,34,8,16.0,5.0,-3
YouGov/Sun,2015-02-05,32,33,9,15.0,5.0,-1
YouGov/Sun,2015-02-04,34,33,6,13.0,7.0,1
YouGov/Sun,2015-02-03,33,33,7,14.0,7.0,0
YouGov/Sun,2015-02-02,33,35,7,14.0,6.0,-2
Populus/,2015-02-02,31,34,8,14.0,5.0,-3
TNS BMRB/,2015-02-02,27,33,6,18.0,8.0,-6
Ashcroft/,2015-02-01,31,31,8,15.0,9.0,0
YouGov/Sunday Times,2015-01-30,32,35,7,15.0,6.0,-3
Opinium/Observer,2015-01-30,32,33,5,18.0,6.0,-1
Populus/,2015-01-29,34,35,10,14.0,4.0,-1
YouGov/Sun,2015-01-29,34,34,6,14.0,7.0,0
YouGov/Sun,2015-01-28,33,33,6,16.0,7.0,0
YouGov/Sun,2015-01-27,34,33,7,14.0,7.0,1
YouGov/Sun,2015-01-26,34,33,6,15.0,7.0,1
ComRes/Independent,2015-01-25,31,30,8,17.0,7.0,1
Ashcroft/,2015-01-25,32,32,6,15.0,9.0,0
Populus/,2015-01-25,34,35,9,13.0,6.0,-1
Survation/Mirror,2015-01-25,31,30,7,23.0,3.0,1
YouGov/Sunday Times,2015-01-23,32,32,7,15.0,7.0,0
Populus/,2015-01-22,32,36,9,13.0,6.0,-4
YouGov/Sun,2015-01-22,31,33,7,17.0,8.0,-2
YouGov/Sun,2015-01-21,33,34,6,14.0,8.0,-1
YouGov/Sun,2015-01-20,32,30,8,15.0,10.0,2
ICM/Guardian,2015-01-19,30,33,11,11.0,9.0,-3
YouGov/Sun,2015-01-19,32,32,8,15.0,7.0,0
TNS BMRB/,2015-01-19,31,31,8,16.0,7.0,0
Populus/,2015-01-18,35,36,8,13.0,4.0,-1
Ashcroft/,2015-01-18,29,28,9,15.0,11.0,1
Opinium/Observer,2015-01-16,28,33,7,20.0,6.0,-5
YouGov/Sunday Times,2015-01-16,31,32,7,18.0,7.0,-1
Populus/,2015-01-15,32,35,9,14.0,6.0,-3
YouGov/Sun on Sunday,2015-01-15,31,33,7,16.0,7.0,-2
ComRes/Independent on Sunday (O),2015-01-15,33,34,7,18.0,3.0,-1
YouGov/Sun,2015-01-15,32,32,6,16.0,8.0,0
YouGov/Sun,2015-01-14,32,34,6,15.0,7.0,-2
YouGov/Sun,2015-01-13,32,33,7,14.0,7.0,-1
Ipsos-MORI/Evening Standard,2015-01-13,33,34,8,11.0,8.0,-1
YouGov/Sun,2015-01-12,32,33,6,17.0,6.0,-1
Populus/,2015-01-11,32,37,10,13.0,4.0,-5
Ashcroft/,2015-01-11,34,28,8,16.0,8.0,6
YouGov/Sunday Times,2015-01-09,32,32,7,18.0,6.0,0
TNS BMRB/,2015-01-08,28,35,6,18.0,5.0,-7
Populus/,2015-01-08,33,34,8,14.0,6.0,-1
YouGov/Sun,2015-01-08,33,33,8,13.0,7.0,0
YouGov/Sun,2015-01-07,32,33,7,15.0,7.0,-1
YouGov/Sun,2015-01-06,33,33,7,13.0,8.0,0
YouGov/Sun,2015-01-05,31,34,7,14.0,8.0,-3
Populus/,2015-01-04,34,35,9,12.0,5.0,-1
Opinium/Observer,2015-01-02,32,33,8,17.0,4.0,-1
YouGov/Sun,2014-12-22,32,36,6,16.0,5.0,-4
Populus/,2014-12-21,35,35,9,12.0,4.0,0
Survation/,2014-12-19,30,33,11,20.0,3.0,-3
Opinium/Observer,2014-12-19,29,36,6,16.0,5.0,-7
YouGov/Sunday Times,2014-12-19,32,34,6,15.0,8.0,-2
Populus/,2014-12-18,34,35,9,13.0,4.0,-1
YouGov/Sun,2014-12-18,30,35,6,16.0,8.0,-5
YouGov/Sun,2014-12-17,33,33,8,14.0,7.0,0
ICM/Guardian,2014-12-16,28,33,14,15.0,5.0,-5
YouGov/Sun,2014-12-16,33,34,6,16.0,6.0,-1
Ipsos-MORI/Evening Standard,2014-12-15,32,29,9,13.0,9.0,3
YouGov/Sun,2014-12-15,32,34,6,14.0,8.0,-2
TNS BMRB/,2014-12-15,28,35,5,19.0,7.0,-7
Populus/,2014-12-14,34,36,10,12.0,5.0,-2
ComRes/Independent,2014-12-14,29,32,12,16.0,5.0,-3
ComRes/Independent on Sunday (O),2014-12-12,33,34,8,18.0,2.0,-1
YouGov/Sunday Times,2014-12-12,32,32,7,16.0,7.0,0
Populus/,2014-12-11,34,35,9,14.0,4.0,-1
YouGov/Sun,2014-12-11,32,34,7,14.0,7.0,-2
YouGov/Sun,2014-12-10,33,33,6,15.0,7.0,0
YouGov/Sun,2014-12-09,32,32,8,15.0,7.0,0
YouGov/Sun,2014-12-08,34,33,6,15.0,6.0,1
Populus/,2014-12-07,33,36,8,15.0,4.0,-3
Ashcroft/,2014-12-07,30,31,8,19.0,5.0,-1
YouGov/Sunday Times,2014-12-05,32,32,6,17.0,7.0,0
Populus/,2014-12-04,33,35,9,14.0,4.0,-2
YouGov/Sun,2014-12-04,31,32,7,15.0,8.0,-1
Opinium/Observer,2014-12-04,29,34,6,19.0,6.0,-5
YouGov/Sun,2014-12-03,32,31,6,17.0,7.0,1
YouGov/Sun,2014-12-02,32,33,7,16.0,7.0,-1
YouGov/Sun,2014-12-01,32,32,8,15.0,6.0,0
Populus/,2014-11-30,32,35,9,14.0,5.0,-3
Ashcroft/,2014-11-30,30,32,7,16.0,6.0,-2
ComRes/Independent,2014-11-30,28,31,9,18.0,7.0,-3
YouGov/Sunday Times,2014-11-28,32,34,7,15.0,6.0,-2
Populus/,2014-11-27,32,37,9,14.0,4.0,-5
YouGov/Sun,2014-11-27,31,31,8,17.0,6.0,0
TNS BMRB/,2014-11-27,30,31,6,19.0,6.0,-1
YouGov/Sun,2014-11-26,33,32,6,16.0,7.0,1
YouGov/Sun,2014-11-25,32,33,7,16.0,6.0,-1
YouGov/Sun,2014-11-24,30,34,6,18.0,6.0,-4
Populus/,2014-11-23,31,36,9,15.0,5.0,-5
Ashcroft/,2014-11-23,27,32,7,18.0,7.0,-5
YouGov/Sunday Times,2014-11-21,33,33,7,16.0,6.0,0
Opinium/Observer,2014-11-20,30,33,7,19.0,4.0,-3
Populus/,2014-11-20,33,36,9,14.0,4.0,-3
YouGov/Sun,2014-11-20,34,33,7,15.0,6.0,1
YouGov/Sun,2014-11-19,34,33,7,14.0,6.0,1
YouGov/Sun,2014-11-18,32,34,7,15.0,6.0,-2
YouGov/Sun,2014-11-17,33,32,7,15.0,8.0,1
Populus/,2014-11-16,35,36,7,11.0,5.0,-1
Ashcroft/,2014-11-16,29,30,9,16.0,7.0,-1
ComRes/Independent on Sunday (O),2014-11-14,30,34,8,19.0,3.0,-4
YouGov/Sunday Times,2014-11-14,31,33,7,18.0,5.0,-2
Populus/,2014-11-13,33,35,9,13.0,4.0,-2
YouGov/Sun,2014-11-13,33,32,8,15.0,6.0,1
YouGov/Sun,2014-11-12,32,35,7,15.0,6.0,-3
YouGov/Sun,2014-11-11,33,34,7,15.0,6.0,-1
YouGov/Sun,2014-11-10,32,33,6,17.0,6.0,-1
Ipsos-MORI/Evening Standard,2014-11-10,32,29,9,14.0,7.0,3
Ashcroft/,2014-11-09,30,29,10,16.0,7.0,1
ICM/Guardian,2014-11-09,31,32,11,14.0,6.0,-1
Populus/,2014-11-09,34,36,8,13.0,4.0,-2
Opinium/Observer,2014-11-07,29,32,9,19.0,4.0,-3
YouGov/Sunday Times,2014-11-07,33,33,7,16.0,6.0,0
Survation/Mail on Sunday,2014-11-07,29,34,6,23.0,4.0,-5
Populus/,2014-11-06,33,35,9,14.0,4.0,-2
YouGov/Sun,2014-11-06,32,33,8,15.0,7.0,-1
YouGov/Sun,2014-11-05,32,33,7,17.0,7.0,-1
YouGov/Sun,2014-11-04,32,34,7,15.0,6.0,-2
YouGov/Sun,2014-11-03,33,34,8,15.0,5.0,-1
Populus/,2014-11-02,34,35,9,13.0,4.0,-1
Ashcroft/,2014-11-02,29,30,9,17.0,6.0,-1
Survation/Mirror,2014-11-01,27,31,9,24.0,3.0,-4
YouGov/Sunday Times,2014-10-31,31,32,7,18.0,6.0,-1
Populus/,2014-10-30,34,34,8,15.0,5.0,0
YouGov/Sun,2014-10-30,33,32,7,15.0,7.0,1
YouGov/Sun,2014-10-29,31,34,6,17.0,7.0,-3
YouGov/Sun,2014-10-28,32,33,8,17.0,5.0,-1
YouGov/Sun,2014-10-27,32,32,8,18.0,6.0,0
Populus/,2014-10-26,34,36,8,13.0,3.0,-2
ComRes/Independent,2014-10-26,30,30,9,19.0,4.0,0
Ashcroft/,2014-10-26,31,31,7,18.0,5.0,0
Opinium/Observer,2014-10-24,33,33,6,18.0,4.0,0
YouGov/Sunday Times,2014-10-24,33,33,7,16.0,6.0,0
Populus/,2014-10-23,33,35,9,15.0,3.0,-2
YouGov/Sun,2014-10-23,34,34,6,15.0,6.0,0
YouGov/Sun,2014-10-22,31,33,7,17.0,6.0,-2
YouGov/Sun,2014-10-21,32,33,8,16.0,5.0,-1
YouGov/Sun,2014-10-20,31,33,7,15.0,6.0,-2
Populus/,2014-10-19,34,36,9,13.0,3.0,-2
Ashcroft/,2014-10-19,28,31,7,18.0,8.0,-3
YouGov/Sunday Times,2014-10-17,32,35,7,16.0,5.0,-3
ComRes/Independent on Sunday (O),2014-10-16,31,34,7,19.0,4.0,-3
Populus/,2014-10-16,33,35,10,14.0,4.0,-2
YouGov/Sun,2014-10-16,31,32,8,18.0,7.0,-1
YouGov/Sun,2014-10-15,31,33,7,19.0,5.0,-2
Ipsos-MORI/Evening Standard,2014-10-14,30,33,8,16.0,5.0,-3
YouGov/Sun,2014-10-14,30,34,8,18.0,5.0,-4
YouGov/Sun,2014-10-13,31,34,7,17.0,4.0,-3
ICM/Guardian,2014-10-12,31,35,11,14.0,4.0,-4
Populus/,2014-10-12,35,36,9,13.0,3.0,-1
Ashcroft/,2014-10-12,28,32,8,19.0,5.0,-4
Survation/Mail on Sunday,2014-10-10,31,31,7,25.0,2.0,0
Opinium/Observer,2014-10-10,28,35,9,17.0,4.0,-7
YouGov/Sunday Times,2014-10-10,32,34,9,16.0,5.0,-2
Populus/,2014-10-09,34,35,9,13.0,4.0,-1
YouGov/Sun,2014-10-09,30,35,9,15.0,5.0,-5
YouGov/Sun,2014-10-08,33,34,7,14.0,6.0,-1
YouGov/Sun,2014-10-07,32,34,8,15.0,5.0,-2
YouGov/Sun,2014-10-06,35,33,8,13.0,4.0,2
Ashcroft/,2014-10-05,32,30,7,17.0,7.0,2
Populus/,2014-10-05,31,37,8,15.0,3.0,-6
YouGov/Sunday Times,2014-10-03,36,34,7,13.0,5.0,2
Populus/,2014-10-02,33,38,8,13.0,3.0,-5
YouGov/Sun,2014-10-02,35,34,6,14.0,5.0,1
YouGov/Sun,2014-10-01,31,38,7,15.0,5.0,-7
YouGov/Sun,2014-09-30,31,36,7,15.0,5.0,-5
YouGov/Sun,2014-09-29,31,36,7,16.0,4.0,-5
ComRes/Independent,2014-09-28,29,35,10,15.0,4.0,-6
Populus/,2014-09-28,34,36,7,14.0,5.0,-2
Ashcroft/,2014-09-28,32,32,8,17.0,4.0,0
ComRes/Independent on Sunday (O),2014-09-26,29,35,7,19.0,4.0,-6
YouGov/Sunday Times,2014-09-26,31,36,6,15.0,6.0,-5
Opinium/Observer,2014-09-26,32,34,7,17.0,4.0,-2
YouGov/Sun,2014-09-25,31,37,7,13.0,5.0,-6
Populus/,2014-09-25,33,37,9,13.0,3.0,-4
YouGov/Sun,2014-09-24,33,37,7,13.0,5.0,-4
YouGov/Sun,2014-09-23,31,37,7,15.0,5.0,-6
YouGov/Sun,2014-09-22,33,35,7,14.0,5.0,-2
Populus/,2014-09-21,33,37,9,12.0,4.0,-4
Ashcroft/,2014-09-21,27,33,9,17.0,7.0,-6
YouGov/Sunday Times,2014-09-19,31,36,7,16.0,5.0,-5
Populus/,2014-09-18,32,36,9,15.0,4.0,-4
YouGov/Sun,2014-09-18,33,35,8,14.0,5.0,-2
YouGov/Sun,2014-09-17,33,36,8,13.0,5.0,-3
YouGov/Sun,2014-09-16,34,37,7,12.0,6.0,-3
YouGov/Sun,2014-09-15,31,35,7,15.0,6.0,-4
Populus/,2014-09-14,34,35,9,13.0,3.0,-1
Ashcroft/,2014-09-14,33,33,9,14.0,6.0,0
ICM/Guardian,2014-09-14,33,35,10,9.0,7.0,-2
Survation/Mail on Sunday,2014-09-12,31,35,8,19.0,3.0,-4
YouGov/Sunday Times,2014-09-12,32,35,7,15.0,6.0,-3
Populus/,2014-09-11,33,37,9,13.0,2.0,-4
Opinium/Observer,2014-09-11,29,37,7,19.0,4.0,-8
YouGov/Sun,2014-09-11,31,35,7,16.0,5.0,-4
YouGov/Sun,2014-09-10,32,38,6,14.0,5.0,-6
Ipsos-MORI/Evening Standard,2014-09-09,34,33,7,15.0,6.0,1
YouGov/Sun,2014-09-09,30,36,8,16.0,5.0,-6
YouGov/Sun,2014-09-08,31,36,8,16.0,5.0,-5
Populus/,2014-09-07,34,36,9,12.0,4.0,-2
Ashcroft/,2014-09-07,28,35,8,18.0,6.0,-7
YouGov/Sunday Times,2014-09-05,33,35,7,15.0,4.0,-2
Populus/,2014-09-04,32,38,8,14.0,4.0,-6
YouGov/Sun,2014-09-04,32,36,7,16.0,5.0,-4
YouGov/Sun,2014-09-03,33,36,7,14.0,5.0,-3
YouGov/Sun,2014-09-02,32,35,8,15.0,5.0,-3
YouGov/Sun,2014-09-01,34,35,7,14.0,5.0,-1
ComRes/Independent,2014-08-31,28,35,9,17.0,6.0,-7
Populus/,2014-08-31,32,36,9,15.0,3.0,-4
Opinium/Observer,2014-08-29,30,36,7,16.0,4.0,-6
YouGov/Sunday Times,2014-08-29,32,36,7,16.0,4.0,-4
Populus/,2014-08-28,35,34,8,13.0,5.0,1
YouGov/Sun,2014-08-28,33,36,7,13.0,5.0,-3
YouGov/Sun,2014-08-27,34,35,7,14.0,6.0,-1
YouGov/Sun,2014-08-26,33,37,8,13.0,5.0,-4
Populus/,2014-08-25,32,38,8,15.0,3.0,-6
ComRes/Independent on Sunday (O),2014-08-22,32,34,8,18.0,3.0,-2
YouGov/Sunday Times,2014-08-22,34,36,8,14.0,5.0,-2
Populus/,2014-08-21,33,39,9,11.0,3.0,-6
YouGov/Sun,2014-08-21,33,38,8,12.0,5.0,-5
YouGov/Sun,2014-08-20,34,38,9,11.0,4.0,-4
YouGov/Sun,2014-08-19,36,37,9,12.0,3.0,-1
YouGov/Sun,2014-08-18,33,38,8,12.0,4.0,-5
Populus/,2014-08-17,32,37,9,14.0,3.0,-5
Opinium/,2014-08-15,28,32,10,21.0,4.0,-4
YouGov/Sunday Times,2014-08-15,34,38,7,13.0,4.0,-4
Populus/,2014-08-14,32,35,9,14.0,5.0,-3
YouGov/Sun,2014-08-14,35,35,8,12.0,5.0,0
YouGov/Sun,2014-08-13,34,36,10,12.0,4.0,-2
YouGov/Sun,2014-08-12,35,38,8,11.0,4.0,-3
YouGov/Sun,2014-08-11,33,37,8,12.0,5.0,-4
Ipsos-MORI/Evening Standard,2014-08-11,33,33,7,13.0,7.0,0
Populus/,2014-08-11,33,37,9,12.0,3.0,-4
ICM/Guardian,2014-08-10,31,38,12,10.0,4.0,-7
YouGov/Sunday Times,2014-08-08,33,37,8,13.0,4.0,-4
Populus/,2014-08-07,36,35,9,11.0,3.0,1
YouGov/Sun,2014-08-07,33,38,7,12.0,4.0,-5
YouGov/Sun,2014-08-06,34,37,9,12.0,4.0,-3
YouGov/Sun,2014-08-05,33,38,8,12.0,4.0,-5
YouGov/Sun,2014-08-04,34,38,6,13.0,4.0,-4
Populus/,2014-08-03,35,37,9,12.0,3.0,-2
Ashcroft/,2014-08-03,30,33,8,18.0,6.0,-3
Opinium/Observer,2014-08-01,32,35,7,15.0,5.0,-3
YouGov/Sunday Times,2014-08-01,35,38,7,12.0,4.0,-3
Populus/,2014-07-31,35,36,8,13.0,4.0,-1
YouGov/Sun,2014-07-31,34,38,8,13.0,4.0,-4
YouGov/Sun,2014-07-30,35,37,8,12.0,4.0,-2
YouGov/Sun,2014-07-29,34,35,8,12.0,6.0,-1
YouGov/Sun,2014-07-28,33,39,8,12.0,4.0,-6
Ashcroft/,2014-07-27,32,34,9,14.0,6.0,-2
Populus/,2014-07-27,33,37,9,12.0,5.0,-4
ComRes/Independent,2014-07-27,27,33,8,17.0,7.0,-6
YouGov/Sunday Times,2014-07-25,35,36,8,13.0,5.0,-1
Populus/,2014-07-24,35,37,9,9.0,4.0,-2
YouGov/Sun,2014-07-24,35,38,8,11.0,4.0,-3
YouGov/Sun,2014-07-23,34,38,8,12.0,4.0,-4
YouGov/Sun,2014-07-22,34,37,7,14.0,5.0,-3
YouGov/Sun,2014-07-21,34,38,9,11.0,4.0,-4
Populus/,2014-07-20,32,37,9,13.0,4.0,-5
Ashcroft/,2014-07-20,27,35,7,17.0,7.0,-8
ComRes/Independent on Sunday (O),2014-07-18,31,34,9,15.0,4.0,-3
YouGov/Sunday Times,2014-07-18,32,37,9,13.0,5.0,-5
TNS BMRB/,2014-07-17,29,36,7,19.0,,-7
Opinium/Observer,2014-07-17,30,34,9,17.0,4.0,-4
Populus/,2014-07-17,35,35,8,14.0,3.0,0
YouGov/Sun,2014-07-17,32,39,8,13.0,4.0,-7
YouGov/Sun,2014-07-16,33,36,9,13.0,4.0,-3
Ipsos-MORI/Evening Standard,2014-07-15,32,35,8,12.0,8.0,-3
YouGov/Sun,2014-07-15,34,38,6,14.0,4.0,-4
YouGov/Sun,2014-07-14,35,38,8,10.0,4.0,-3
Ashcroft/,2014-07-13,32,36,7,14.0,6.0,-4
Populus/,2014-07-13,34,37,9,12.0,3.0,-3
ICM/Guardian,2014-07-13,34,33,12,9.0,4.0,1
YouGov/Sunday Times,2014-07-11,33,38,9,12.0,4.0,-5
Populus/,2014-07-10,34,36,8,12.0,5.0,-2
YouGov/Sun,2014-07-10,34,37,8,12.0,5.0,-3
YouGov/Sun,2014-07-09,32,36,10,12.0,5.0,-4
YouGov/Sun,2014-07-08,31,38,8,12.0,5.0,-7
YouGov/Sun,2014-07-07,34,37,9,13.0,4.0,-3
Populus/,2014-07-06,31,38,9,14.0,4.0,-7
Ashcroft/,2014-07-06,27,34,11,15.0,6.0,-7
YouGov/Sun on Sunday,2014-07-04,35,37,8,12.0,5.0,-2
YouGov/Sunday Times,2014-07-04,34,36,8,13.0,5.0,-2
Populus/,2014-07-03,34,35,9,14.0,4.0,-1
Opinium/,2014-07-03,29,35,7,18.0,5.0,-6
YouGov/Sun,2014-07-03,35,36,8,12.0,5.0,-1
YouGov/Sun,2014-07-02,35,37,8,12.0,5.0,-2
YouGov/Sun,2014-07-01,33,38,8,11.0,5.0,-5
YouGov/Sun,2014-06-30,35,37,8,12.0,3.0,-2
ComRes/Independent,2014-06-29,30,32,7,18.0,5.0,-2
Ashcroft/,2014-06-29,33,31,9,15.0,6.0,2
Populus/,2014-06-29,33,37,10,12.0,4.0,-4
Survation/Mail on Sunday,2014-06-27,27,36,7,22.0,5.0,-9
YouGov/Sunday Times,2014-06-27,33,37,8,14.0,5.0,-4
Populus/,2014-06-26,34,35,8,13.0,5.0,-1
YouGov/Sun,2014-06-26,33,38,8,13.0,4.0,-5
YouGov/Sun,2014-06-25,32,37,7,14.0,5.0,-5
YouGov/Sun,2014-06-24,33,36,8,15.0,4.0,-3
YouGov/Sun,2014-06-23,32,36,9,15.0,4.0,-4
Populus/,2014-06-22,32,37,9,13.0,3.0,-5
Ashcroft/,2014-06-22,28,33,9,17.0,7.0,-5
YouGov/Sunday Times,2014-06-20,32,38,8,14.0,5.0,-6
Opinium/Observer,2014-06-19,31,35,7,17.0,5.0,-4
Populus/,2014-06-19,34,36,8,13.0,3.0,-2
YouGov/Sun,2014-06-19,33,37,8,15.0,3.0,-4
YouGov/Sun,2014-06-18,34,38,7,13.0,5.0,-4
Ipsos-MORI/Evening Standard,2014-06-17,31,34,8,14.0,8.0,-3
YouGov/Sun,2014-06-17,34,37,7,13.0,4.0,-3
YouGov/Sun,2014-06-16,32,36,10,14.0,5.0,-4
ICM/Guardian,2014-06-15,31,32,10,16.0,6.0,-1
Populus/,2014-06-15,33,37,9,13.0,4.0,-4
Ashcroft/,2014-06-15,29,35,8,15.0,6.0,-6
YouGov/Sunday Times,2014-06-13,33,37,8,13.0,5.0,-4
ComRes/Independent on Sunday (O),2014-06-13,32,34,7,18.0,4.0,-2
Populus/,2014-06-12,32,35,8,15.0,5.0,-3
YouGov/Sun on Sunday,2014-06-12,33,36,8,14.0,5.0,-3
TNS BMRB/,2014-06-12,29,35,6,23.0,3.0,-6
YouGov/Sun,2014-06-12,32,38,8,12.0,5.0,-6
YouGov/Sun,2014-06-11,34,36,6,14.0,5.0,-2
YouGov/Sun,2014-06-10,35,37,8,12.0,3.0,-2
YouGov/Sun,2014-06-09,31,37,7,15.0,5.0,-6
Populus/,2014-06-08,35,36,9,14.0,3.0,-1
Ashcroft/,2014-06-08,28,32,8,17.0,7.0,-4
Populus/,2014-06-06,34,35,9,14.0,5.0,-1
YouGov/Sunday Times,2014-06-06,33,37,7,14.0,5.0,-4
Opinium/Observer,2014-06-05,31,35,6,19.0,4.0,-4
YouGov/Sun,2014-06-05,31,37,8,15.0,5.0,-6
YouGov/Sun,2014-06-04,32,37,7,13.0,5.0,-5
YouGov/Sun,2014-06-03,32,36,8,14.0,5.0,-4
YouGov/Sun,2014-06-02,30,36,8,17.0,5.0,-6
Populus/,2014-06-01,32,37,10,13.0,3.0,-5
Ashcroft/,2014-06-01,25,34,6,19.0,7.0,-9
YouGov/Sunday Times,2014-05-30,33,36,7,15.0,4.0,-3
Populus/,2014-05-29,34,35,9,14.0,4.0,-1
YouGov/Sun,2014-05-29,31,38,7,16.0,4.0,-7
YouGov/Sun,2014-05-28,32,36,9,14.0,5.0,-4
YouGov/Sun,2014-05-27,32,34,8,15.0,5.0,-2
Populus/,2014-05-26,34,36,9,14.0,3.0,-2
Ashcroft/,2014-05-25,29,31,8,17.0,7.0,-2
Opinium/Observer,2014-05-23,32,33,7,19.0,4.0,-1
YouGov/Sunday Times,2014-05-23,34,35,9,13.0,5.0,-1
Populus/,2014-05-22,34,36,9,14.0,3.0,-2
YouGov/Sun,2014-05-22,34,34,9,14.0,5.0,0
YouGov/Sun,2014-05-21,33,36,9,13.0,4.0,-3
YouGov/Sun,2014-05-20,33,35,11,13.0,3.0,-2
Survation/Mirror,2014-05-20,28,35,8,21.0,3.0,-7
YouGov/Sun,2014-05-19,33,37,9,11.0,6.0,-4
Populus/,2014-05-18,35,34,8,14.0,3.0,1
ComRes/Independent,2014-05-18,30,35,8,14.0,5.0,-5
Ashcroft/,2014-05-18,29,35,9,14.0,5.0,-6
YouGov/Sunday Times,2014-05-16,34,37,9,13.0,4.0,-3
ComRes/Independent on Sunday (O),2014-05-15,29,33,8,19.0,4.0,-4
Populus/,2014-05-15,32,36,10,13.0,3.0,-4
YouGov/Sun,2014-05-15,34,36,8,13.0,4.0,-2
YouGov/Sun,2014-05-14,32,35,10,13.0,4.0,-3
YouGov/Sun,2014-05-13,34,34,8,15.0,3.0,0
Ipsos-MORI/Evening Standard,2014-05-12,31,34,9,11.0,8.0,-3
YouGov/Sun,2014-05-12,35,36,9,14.0,3.0,-1
ICM/Guardian,2014-05-11,33,31,13,15.0,4.0,2
Populus/,2014-05-11,35,36,8,13.0,3.0,-1
Ashcroft/,2014-05-11,34,32,9,15.0,5.0,2
Survation/Mail on Sunday,2014-05-09,28,34,10,20.0,3.0,-6
YouGov/Sunday Times,2014-05-09,31,38,9,13.0,4.0,-7
Opinium/,2014-05-08,29,33,9,20.0,4.0,-4
Populus/,2014-05-08,32,36,8,16.0,4.0,-4
YouGov/Sun,2014-05-08,34,35,8,13.0,4.0,-1
YouGov/Sun,2014-05-07,34,37,8,13.0,3.0,-3
YouGov/Sun,2014-05-06,34,35,9,14.0,3.0,-1
Populus/,2014-05-05,33,36,8,14.0,4.0,-3
Survation/Mirror,2014-05-03,33,34,8,18.0,2.0,-1
YouGov/Sunday Times,2014-05-02,33,36,9,15.0,4.0,-3
Populus/,2014-05-01,34,35,9,14.0,3.0,-1
YouGov/Sun on Sunday,2014-05-01,33,36,10,15.0,2.0,-3
YouGov/Sun,2014-05-01,33,36,10,14.0,3.0,-3
YouGov/Sun,2014-04-30,31,37,9,15.0,3.0,-6
YouGov/Sun,2014-04-29,32,37,9,14.0,3.0,-5
YouGov/Sun,2014-04-28,32,37,10,15.0,2.0,-5
Populus/,2014-04-27,32,35,10,15.0,3.0,-3
Opinium/Observer,2014-04-25,32,34,7,18.0,3.0,-2
YouGov/Sunday Times,2014-04-25,31,36,9,15.0,4.0,-5
Populus/,2014-04-24,35,35,9,13.0,3.0,0
YouGov/Sun,2014-04-24,32,38,8,14.0,4.0,-6
YouGov/Sun,2014-04-23,32,37,10,15.0,2.0,-5
YouGov/Sun,2014-04-22,34,37,10,12.0,2.0,-3
Populus/,2014-04-21,33,36,10,13.0,3.0,-3
YouGov/Sun,2014-04-17,33,35,11,15.0,2.0,-2
Populus/,2014-04-16,34,35,9,14.0,3.0,-1
YouGov/Sun,2014-04-16,33,39,9,11.0,3.0,-6
YouGov/Sun,2014-04-15,34,37,10,13.0,2.0,-3
YouGov/Sun,2014-04-14,33,38,9,12.0,3.0,-5
Populus/,2014-04-13,33,35,11,13.0,2.0,-2
ICM/Guardian,2014-04-13,32,37,12,11.0,2.0,-5
ComRes/Independent,2014-04-13,30,36,9,12.0,4.0,-6
YouGov/Sunday Times,2014-04-11,32,38,8,14.0,2.0,-6
Populus/,2014-04-10,34,35,11,12.0,2.0,-1
ComRes/Independent on Sunday (O),2014-04-10,29,35,7,20.0,4.0,-6
YouGov/Sun,2014-04-10,32,38,8,14.0,2.0,-6
Opinium/Observer,2014-04-10,30,36,7,18.0,3.0,-6
YouGov/Sun,2014-04-09,33,36,10,14.0,2.0,-3
YouGov/Sun,2014-04-08,33,37,10,13.0,2.0,-4
Ipsos-MORI/Evening Standard,2014-04-07,31,37,9,15.0,3.0,-6
YouGov/Sun,2014-04-07,33,36,10,14.0,2.0,-3
Populus/,2014-04-06,34,37,9,14.0,3.0,-3
YouGov/Sunday Times,2014-04-04,34,39,9,12.0,2.0,-5
YouGov/Sun,2014-04-03,32,38,10,13.0,3.0,-6
YouGov/Sun,2014-04-02,32,38,10,13.0,2.0,-6
YouGov/Sun,2014-04-01,33,37,10,12.0,2.0,-4
YouGov/Sun,2014-03-31,34,37,11,13.0,2.0,-3
Populus/,2014-03-30,34,37,10,11.0,3.0,-3
Opinium/Observer,2014-03-28,32,33,10,15.0,3.0,-1
Populus/,2014-03-28,35,37,8,12.0,3.0,-2
YouGov/Sunday Times,2014-03-28,33,40,9,11.0,2.0,-7
YouGov/Sun,2014-03-27,35,36,10,11.0,3.0,-1
YouGov/Sun,2014-03-26,35,37,9,11.0,2.0,-2
YouGov/Sun,2014-03-25,35,38,10,10.0,2.0,-3
YouGov/Sun,2014-03-24,36,38,10,10.0,2.0,-2
Populus/,2014-03-23,34,35,10,13.0,2.0,-1
ComRes/Independent on Sunday,2014-03-23,31,36,9,11.0,5.0,-5
YouGov/Sunday Times,2014-03-21,36,37,9,11.0,2.0,-1
Survation/Mail on Sunday,2014-03-21,34,35,9,15.0,2.0,-1
Populus/,2014-03-20,34,38,9,12.0,2.0,-4
YouGov/Sun,2014-03-20,34,39,10,10.0,2.0,-5
YouGov/Sun,2014-03-19,33,38,11,11.0,3.0,-5
YouGov/Sun,2014-03-18,34,38,11,11.0,3.0,-4
YouGov/Sun,2014-03-17,32,40,9,11.0,3.0,-8
Populus/,2014-03-16,32,36,10,13.0,3.0,-4
YouGov/Sunday Times,2014-03-14,33,40,8,12.0,2.0,-7
ComRes/Independent on Sunday (O),2014-03-13,32,35,9,16.0,3.0,-3
Populus/,2014-03-13,34,35,10,13.0,2.0,-1
YouGov/Sun,2014-03-13,33,38,11,10.0,2.0,-5
Opinium/Observer,2014-03-12,30,35,10,16.0,3.0,-5
Ipsos-MORI/Evening Standard,2014-03-12,32,35,13,11.0,5.0,-3
YouGov/Sun,2014-03-12,35,37,9,13.0,2.0,-2
YouGov/Sun,2014-03-11,34,38,10,12.0,2.0,-4
ICM/Guardian,2014-03-11,35,38,12,9.0,3.0,-3
YouGov/Sun,2014-03-10,32,39,8,13.0,3.0,-7
Populus/,2014-03-09,34,38,9,12.0,3.0,-4
YouGov/Sunday Times,2014-03-07,32,39,10,14.0,2.0,-7
Populus/,2014-03-06,34,37,9,12.0,3.0,-3
YouGov/Sun,2014-03-06,31,40,9,13.0,3.0,-9
YouGov/Sun,2014-03-05,34,37,10,11.0,3.0,-3
YouGov/Sun,2014-03-04,34,38,9,13.0,2.0,-4
YouGov/Sun,2014-03-03,32,41,8,12.0,1.0,-9
Populus/,2014-03-02,34,37,10,12.0,3.0,-3
ComRes/Independent,2014-03-02,30,38,10,11.0,4.0,-8
YouGov/Sunday Times,2014-02-28,34,38,9,12.0,2.0,-4
Opinium/Observer,2014-02-28,29,34,10,19.0,3.0,-5
Populus/,2014-02-27,33,38,9,13.0,3.0,-5
YouGov/Sun,2014-02-27,34,39,8,12.0,3.0,-5
YouGov/Sun,2014-02-26,34,40,10,11.0,3.0,-6
YouGov/Sun,2014-02-25,33,39,10,11.0,3.0,-6
YouGov/Sun,2014-02-24,33,38,10,13.0,2.0,-5
Populus/,2014-02-23,32,37,10,15.0,2.0,-5
YouGov/Sunday Times,2014-02-21,32,39,8,12.0,2.0,-7
Populus/,2014-02-20,32,38,9,13.0,3.0,-6
YouGov/Sun,2014-02-20,34,39,9,12.0,2.0,-5
YouGov/Sun,2014-02-19,33,37,10,12.0,3.0,-4
YouGov/Sun,2014-02-18,33,40,8,12.0,3.0,-7
YouGov/Sun,2014-02-17,33,40,9,11.0,2.0,-7
Populus/,2014-02-16,33,38,10,13.0,3.0,-5
ComRes/Independent on Sunday (O),2014-02-16,32,37,9,15.0,2.0,-5
Opinium/Observer,2014-02-14,28,37,8,17.0,2.0,-9
YouGov/Sunday Times,2014-02-14,32,39,9,12.0,3.0,-7
Populus/,2014-02-13,32,38,9,14.0,3.0,-5
YouGov/Sun,2014-02-13,33,39,9,12.0,2.0,-6
YouGov/Sun,2014-02-12,32,39,8,13.0,2.0,-7
YouGov/Sun,2014-02-11,34,39,10,11.0,2.0,-5
YouGov/Sun,2014-02-10,33,39,10,12.0,2.0,-6
Populus/,2014-02-09,34,36,11,12.0,3.0,-2
ICM/Guardian,2014-02-09,34,38,10,11.0,3.0,-4
YouGov/Sunday Times,2014-02-07,35,39,10,10.0,3.0,-4
Populus/,2014-02-06,33,36,9,15.0,2.0,-3
YouGov/Sun,2014-02-06,32,38,10,14.0,2.0,-6
YouGov/Sun,2014-02-05,35,39,9,10.0,2.0,-4
YouGov/Sun,2014-02-04,33,39,8,13.0,3.0,-6
Ipsos-MORI/Evening Standard,2014-02-03,31,38,12,10.0,3.0,-7
YouGov/Sun,2014-02-03,33,38,11,11.0,1.0,-5
Populus/,2014-02-02,32,41,11,9.0,3.0,-9
Opinium/Observer,2014-01-31,29,36,8,17.0,4.0,-7
YouGov/Sunday Times,2014-01-31,34,39,8,11.0,3.0,-5
Populus/,2014-01-30,32,39,11,10.0,3.0,-7
YouGov/Sun,2014-01-30,32,42,8,12.0,2.0,-10
YouGov/Sun,2014-01-29,35,38,10,11.0,2.0,-3
YouGov/Sun,2014-01-28,34,37,9,12.0,3.0,-3
YouGov/Sun,2014-01-27,35,37,9,13.0,2.0,-2
ComRes/Independent,2014-01-26,32,33,9,14.0,5.0,-1
Populus/,2014-01-26,33,40,11,8.0,3.0,-7
YouGov/Sunday Times,2014-01-24,32,39,9,13.0,2.0,-7
Populus/,2014-01-23,32,40,11,9.0,3.0,-8
YouGov/Sun,2014-01-23,35,38,8,12.0,2.0,-3
YouGov/Sun,2014-01-22,32,40,8,12.0,3.0,-8
YouGov/Sun,2014-01-21,34,38,9,13.0,3.0,-4
YouGov/Sun,2014-01-20,32,40,11,12.0,2.0,-8
Populus/,2014-01-19,32,39,12,9.0,3.0,-7
YouGov/Sunday Times,2014-01-17,33,39,8,13.0,2.0,-6
Opinium/Observer,2014-01-16,30,36,8,17.0,3.0,-6
ComRes/Independent on Sunday (O),2014-01-16,30,35,8,19.0,3.0,-5
YouGov/Sun,2014-01-16,32,39,10,12.0,2.0,-7
Populus/,2014-01-16,33,40,13,9.0,2.0,-7
Survation/Sky News,2014-01-15,30,34,12,18.0,2.0,-4
YouGov/Sun,2014-01-15,33,39,10,12.0,2.0,-6
Ipsos-MORI/Evening Standard,2014-01-14,30,39,13,11.0,3.0,-9
YouGov/Sun,2014-01-14,34,37,9,13.0,2.0,-3
YouGov/Sun,2014-01-13,33,38,11,12.0,2.0,-5
ICM/Guardian,2014-01-12,32,35,14,10.0,3.0,-3
Populus/,2014-01-11,33,38,12,9.0,3.0,-5
YouGov/Sunday Times,2014-01-10,31,40,9,14.0,2.0,-9
Populus/,2014-01-09,33,40,11,8.0,3.0,-7
YouGov/Sun,2014-01-09,32,38,9,13.0,2.0,-6
YouGov/Sun,2014-01-08,32,38,9,13.0,3.0,-6
YouGov/Sun,2014-01-07,32,37,10,14.0,3.0,-5
YouGov/Sun,2014-01-06,32,40,9,12.0,2.0,-8
Survation/Mail on Sunday,2014-01-03,31,35,11,16.0,3.0,-4
Opinium/Observer,2014-01-02,30,37,8,17.0,3.0,-7
Populus/,2013-12-22,35,37,12,9.0,3.0,-2
YouGov/Sunday Times,2013-12-20,34,40,9,11.0,2.0,-6
Populus/,2013-12-19,32,40,12,8.0,3.0,-8
YouGov/Sun,2013-12-19,34,39,11,12.0,1.0,-5
YouGov/Sun,2013-12-18,34,38,10,11.0,2.0,-4
YouGov/Sun,2013-12-17,33,41,8,13.0,2.0,-8
YouGov/Sun,2013-12-16,36,38,8,11.0,2.0,-2
ComRes/Independent,2013-12-15,32,37,9,10.0,5.0,-5
Populus/,2013-12-15,33,40,13,8.0,2.0,-7
ComRes/Independent on Sunday (O),2013-12-13,29,36,8,18.0,4.0,-7
YouGov/Sunday Times,2013-12-13,32,38,9,13.0,2.0,-6
Opinium/Observer,2013-12-13,30,37,8,16.0,4.0,-7
Populus/,2013-12-12,33,38,13,9.0,3.0,-5
YouGov/Sun,2013-12-12,35,39,9,11.0,2.0,-4
YouGov/Sun,2013-12-11,33,39,9,13.0,2.0,-6
YouGov/Sun,2013-12-10,34,39,9,12.0,2.0,-5
Ipsos-MORI/Evening Standard,2013-12-09,33,37,9,10.0,4.0,-4
YouGov/Sun,2013-12-09,33,38,10,13.0,2.0,-5
Populus/,2013-12-08,33,41,11,7.0,3.0,-8
ICM/Guardian,2013-12-08,32,37,12,9.0,3.0,-5
YouGov/Sunday Times,2013-12-06,34,39,10,11.0,3.0,-5
Populus/,2013-12-05,34,38,13,7.0,3.0,-4
YouGov/Sun,2013-12-05,29,41,9,14.0,2.0,-12
YouGov/Sun,2013-12-04,34,40,10,10.0,3.0,-6
YouGov/Sun,2013-12-03,32,40,9,12.0,3.0,-8
YouGov/Sun,2013-12-02,32,38,10,12.0,2.0,-6
Populus/,2013-12-01,33,40,10,9.0,3.0,-7
Opinium/Observer,2013-11-29,28,35,8,19.0,4.0,-7
YouGov/Sunday Times,2013-11-29,30,38,10,15.0,2.0,-8
Populus/,2013-11-28,35,38,12,7.0,3.0,-3
YouGov/Sun,2013-11-28,33,39,8,14.0,2.0,-6
YouGov/Sun,2013-11-27,32,39,10,13.0,2.0,-7
YouGov/Sun,2013-11-26,32,39,10,12.0,3.0,-7
YouGov/Sun,2013-11-25,32,40,10,12.0,2.0,-8
Populus/,2013-11-24,34,39,12,7.0,3.0,-5
ComRes/Independent,2013-11-24,32,37,9,11.0,3.0,-5
Survation/Daily Star,2013-11-22,29,36,10,18.0,3.0,-7
YouGov/Sunday Times,2013-11-22,33,40,9,11.0,2.0,-7
Populus/,2013-11-21,33,38,11,11.0,2.0,-5
YouGov/Sun,2013-11-21,32,39,10,12.0,2.0,-7
YouGov/Sun,2013-11-20,32,40,9,12.0,3.0,-8
YouGov/Sun,2013-11-19,34,38,10,11.0,2.0,-4
YouGov/Sun,2013-11-18,32,39,11,12.0,2.0,-7
Populus/,2013-11-17,32,41,10,9.0,3.0,-9
ComRes/Independent on Sunday (O),2013-11-15,29,35,10,17.0,5.0,-6
YouGov/Sunday Times,2013-11-15,33,39,10,12.0,2.0,-6
Opinium/Observer,2013-11-14,28,37,9,16.0,4.0,-9
Populus/,2013-11-14,31,40,11,10.0,3.0,-9
YouGov/Sun,2013-11-14,32,40,10,13.0,2.0,-8
YouGov/Sun,2013-11-13,31,39,9,13.0,2.0,-8
YouGov/Sun,2013-11-12,32,42,8,10.0,3.0,-10
YouGov/Sun,2013-11-11,33,40,9,11.0,3.0,-7
Ipsos-MORI/Evening Standard,2013-11-11,32,38,8,8.0,7.0,-6
TNS BMRB/,2013-11-11,30,38,8,12.0,4.0,-8
Populus/,2013-11-10,31,39,11,10.0,3.0,-8
ICM/Guardian,2013-11-10,30,38,13,11.0,3.0,-8
YouGov/Sunday Times,2013-11-08,34,39,10,11.0,2.0,-5
Populus/,2013-11-07,32,39,12,9.0,3.0,-7
YouGov/Sun,2013-11-07,33,39,10,11.0,2.0,-6
YouGov/Sun,2013-11-06,33,40,9,12.0,3.0,-7
YouGov/Sun,2013-11-05,34,40,8,11.0,2.0,-6
YouGov/Sun,2013-11-04,33,40,9,12.0,2.0,-7
Populus/,2013-11-03,34,39,10,10.0,3.0,-5
Opinium/Observer,2013-11-01,31,37,7,16.0,3.0,-6
YouGov/Sunday Times,2013-11-01,32,41,8,12.0,2.0,-9
Populus/,2013-10-31,33,40,11,9.0,2.0,-7
YouGov/Sun,2013-10-31,35,39,9,10.0,2.0,-4
YouGov/Sun,2013-10-30,33,40,8,11.0,2.0,-7
YouGov/Sun,2013-10-29,33,39,10,11.0,2.0,-6
YouGov/Sun,2013-10-28,31,40,9,12.0,3.0,-9
Populus/,2013-10-27,33,38,12,9.0,3.0,-5
ComRes/Independent,2013-10-27,28,36,11,12.0,5.0,-8
Survation/Mail on Sunday,2013-10-25,29,35,12,17.0,2.0,-6
YouGov/Sunday Times,2013-10-25,33,39,9,12.0,3.0,-6
Populus/,2013-10-24,34,39,11,10.0,3.0,-5
YouGov/Sun,2013-10-24,32,38,10,13.0,3.0,-6
YouGov/Sun,2013-10-23,32,39,9,11.0,3.0,-7
YouGov/Sun,2013-10-22,32,40,10,13.0,2.0,-8
YouGov/Sun,2013-10-21,33,38,9,13.0,2.0,-5
Survation/Free Speech Network,2013-10-21,29,37,10,16.0,3.0,-8
Populus/,2013-10-19,34,37,14,8.0,3.0,-3
Opinium/Observer,2013-10-18,27,38,9,17.0,4.0,-11
ComRes/Independent on Sunday (O),2013-10-18,32,35,9,16.0,3.0,-3
YouGov/Sunday Times,2013-10-18,33,39,10,11.0,2.0,-6
Populus/,2013-10-17,33,39,12,9.0,2.0,-6
YouGov/Sun,2013-10-17,34,40,9,11.0,2.0,-6
YouGov/Sun,2013-10-16,35,39,8,12.0,2.0,-4
Ipsos-MORI/Evening Standard,2013-10-15,35,35,9,10.0,4.0,0
YouGov/Sun,2013-10-15,34,39,9,11.0,2.0,-5
YouGov/Sun,2013-10-14,37,38,10,10.0,2.0,-1
TNS BMRB/,2013-10-14,34,36,9,13.0,3.0,-2
Populus/,2013-10-13,34,39,12,8.0,3.0,-5
ICM/Guardian,2013-10-13,34,38,12,8.0,3.0,-4
Survation/Mail on Sunday,2013-10-11,27,37,11,18.0,2.0,-10
YouGov/Sunday Times,2013-10-11,34,39,9,11.0,3.0,-5
Populus/,2013-10-10,34,39,12,8.0,3.0,-5
YouGov/Sun,2013-10-10,33,40,10,11.0,2.0,-7
YouGov/Sun,2013-10-09,32,38,11,13.0,3.0,-6
YouGov/Sun,2013-10-08,33,39,10,10.0,3.0,-6
YouGov/Sun,2013-10-07,35,39,9,10.0,3.0,-4
Populus/,2013-10-06,33,40,10,10.0,3.0,-7
Opinium/Observer,2013-10-04,31,36,7,15.0,4.0,-5
YouGov/Sunday Times,2013-10-04,33,38,11,13.0,2.0,-5
Populus/,2013-10-03,33,38,11,10.0,3.0,-5
YouGov/Sun,2013-10-03,35,38,9,10.0,2.0,-3
YouGov/Sun,2013-10-02,34,40,9,10.0,3.0,-6
YouGov/Sun,2013-10-01,31,41,8,12.0,2.0,-10
YouGov/Sun,2013-09-30,33,39,11,13.0,2.0,-6
Populus/,2013-09-29,36,39,11,7.0,3.0,-3
ComRes/Independent,2013-09-29,33,37,11,11.0,3.0,-4
YouGov/Sunday Times,2013-09-27,31,42,9,13.0,2.0,-11
Populus/,2013-09-26,34,37,12,9.0,2.0,-3
YouGov/Sun,2013-09-26,33,40,9,11.0,2.0,-7
YouGov/Sun,2013-09-25,32,41,8,11.0,3.0,-9
YouGov/Sun,2013-09-24,34,39,10,10.0,3.0,-5
YouGov/Sun,2013-09-23,32,40,10,12.0,2.0,-8
Populus/,2013-09-22,33,39,14,9.0,2.0,-6
YouGov/Sunday Times,2013-09-20,33,37,11,11.0,3.0,-4
Opinium/Observer,2013-09-19,29,36,7,17.0,4.0,-7
ComRes/Independent on Sunday (O),2013-09-19,28,36,10,17.0,4.0,-8
Populus/,2013-09-19,33,39,11,9.0,3.0,-6
YouGov/Sun,2013-09-19,34,35,11,11.0,3.0,-1
YouGov/Sun,2013-09-18,36,36,10,12.0,2.0,0
YouGov/Sun,2013-09-17,33,37,9,13.0,3.0,-4
YouGov/Sun,2013-09-16,34,37,10,12.0,3.0,-3
TNS BMRB/,2013-09-16,29,39,9,14.0,2.0,-10
Populus/,2013-09-15,33,40,11,9.0,2.0,-7
ICM/Guardian,2013-09-15,32,36,14,9.0,4.0,-4
YouGov/Sunday Times,2013-09-13,33,38,9,12.0,3.0,-5
YouGov/Sun,2013-09-12,34,38,8,13.0,3.0,-4
Populus/,2013-09-12,34,41,10,7.0,3.0,-7
YouGov/Sun,2013-09-11,32,39,10,12.0,2.0,-7
YouGov/Sun,2013-09-10,33,39,9,11.0,3.0,-6
YouGov/Sun,2013-09-09,33,38,8,14.0,3.0,-5
Ipsos-MORI/Evening Standard,2013-09-09,34,37,10,11.0,3.0,-3
Populus/,2013-09-08,34,37,13,9.0,2.0,-3
Opinium/Observer,2013-09-06,30,35,7,17.0,4.0,-5
YouGov/Sunday Times,2013-09-06,34,38,9,12.0,3.0,-4
Populus/,2013-09-05,33,37,14,8.0,3.0,-4
YouGov/Sun,2013-09-05,31,38,10,13.0,2.0,-7
YouGov/Sun,2013-09-04,33,39,10,12.0,2.0,-6
YouGov/Sun,2013-09-03,33,37,9,13.0,3.0,-4
YouGov/Sun,2013-09-02,33,40,9,12.0,2.0,-7
ComRes/Independent,2013-09-01,31,37,12,10.0,4.0,-6
Populus/,2013-09-01,34,38,12,8.0,3.0,-4
YouGov/Sunday Times,2013-08-31,31,41,9,13.0,2.0,-10
Survation/Mail on Sunday,2013-08-30,29,37,11,17.0,2.0,-8
Populus/,2013-08-29,33,39,12,9.0,2.0,-6
YouGov/Sun,2013-08-29,33,37,10,12.0,3.0,-4
YouGov/Sun,2013-08-28,34,37,11,12.0,2.0,-3
YouGov/Sun,2013-08-27,34,39,8,12.0,2.0,-5
Populus/,2013-08-26,33,37,13,10.0,2.0,-4
Opinium/Observer,2013-08-23,29,36,8,18.0,4.0,-7
YouGov/Sunday Times,2013-08-23,32,38,10,13.0,3.0,-6
Populus/,2013-08-22,30,38,12,12.0,3.0,-8
YouGov/Sun,2013-08-22,32,39,11,10.0,2.0,-7
YouGov/Sun,2013-08-21,34,37,9,13.0,3.0,-3
YouGov/Sun,2013-08-20,32,39,10,12.0,3.0,-7
YouGov/Sun,2013-08-19,31,38,10,14.0,3.0,-7
Populus/,2013-08-18,32,38,12,11.0,3.0,-6
YouGov/Sunday Times,2013-08-16,32,38,10,13.0,3.0,-6
ComRes/Independent (O),2013-08-15,28,37,8,19.0,3.0,-9
Populus/,2013-08-15,36,39,10,8.0,2.0,-3
YouGov/Sun,2013-08-15,34,39,9,11.0,2.0,-5
YouGov/Sun,2013-08-14,32,38,11,13.0,2.0,-6
YouGov/Sun,2013-08-13,35,38,10,11.0,2.0,-3
Ipsos-MORI/Evening Standard,2013-08-12,30,40,10,11.0,6.0,-10
YouGov/Sun,2013-08-12,33,40,8,13.0,2.0,-7
Populus/,2013-08-11,33,39,12,10.0,2.0,-6
ICM/Guardian,2013-08-11,32,35,14,10.0,3.0,-3
YouGov/Sunday Times,2013-08-09,33,41,9,10.0,3.0,-8
Opinium/Observer,2013-08-08,29,36,9,17.0,3.0,-7
Populus/,2013-08-08,32,38,12,9.0,3.0,-6
YouGov/Sun,2013-08-08,34,38,9,12.0,2.0,-4
YouGov/Sun,2013-08-07,31,39,11,11.0,4.0,-8
YouGov/Sun,2013-08-06,32,39,10,11.0,2.0,-7
YouGov/Sun,2013-08-05,34,38,11,12.0,2.0,-4
Populus/,2013-08-04,33,38,12,9.0,3.0,-5
Survation/Mail on Sunday,2013-08-02,28,36,11,18.0,1.0,-8
YouGov/Sunday Times,2013-08-02,32,38,10,13.0,2.0,-6
Populus/,2013-08-01,29,40,11,12.0,3.0,-11
YouGov/Sun,2013-08-01,34,40,10,11.0,3.0,-6
YouGov/Sun,2013-07-31,33,38,10,14.0,2.0,-4
YouGov/Sun,2013-07-30,34,40,11,10.0,2.0,-6
YouGov/Sun,2013-07-29,33,40,10,12.0,2.0,-7
Populus/,2013-07-28,34,39,11,8.0,3.0,-5
ComRes/Independent,2013-07-27,34,37,10,12.0,4.0,-3
Opinium/Observer,2013-07-26,28,39,8,16.0,3.0,-11
YouGov/Sunday Times,2013-07-26,33,39,10,11.0,2.0,-6
Populus/,2013-07-25,32,39,11,10.0,3.0,-7
YouGov/Sun,2013-07-25,32,38,11,11.0,3.0,-6
YouGov/Sun,2013-07-24,35,39,8,11.0,3.0,-4
YouGov/Sun,2013-07-23,32,39,11,12.0,2.0,-7
YouGov/Sun,2013-07-22,35,38,11,10.0,2.0,-3
TNS BMRB/,2013-07-22,28,38,9,16.0,2.0,-10
Populus/,2013-07-21,32,39,12,9.0,2.0,-7
YouGov/Sunday Times,2013-07-19,32,39,10,11.0,2.0,-7
Populus/,2013-07-18,31,39,12,10.0,3.0,-8
YouGov/Sun,2013-07-18,33,38,11,11.0,2.0,-5
YouGov/Sun,2013-07-17,31,37,12,13.0,3.0,-6
YouGov/Sun,2013-07-16,32,38,10,12.0,2.0,-6
Ipsos-MORI/Evening Standard,2013-07-15,29,40,10,12.0,4.0,-11
YouGov/Sun,2013-07-15,31,40,11,11.0,2.0,-9
ICM/Guardian,2013-07-14,36,36,13,7.0,3.0,0
Populus/,2013-07-14,31,38,13,10.0,4.0,-7
Survation/Mail on Sunday,2013-07-12,28,36,9,20.0,4.0,-8
Opinium/Observer,2013-07-12,27,38,6,19.0,4.0,-11
YouGov/Sunday Times,2013-07-12,30,41,10,13.0,2.0,-11
ComRes/Independent on Sunday (O),2013-07-11,28,36,8,18.0,4.0,-8
YouGov/Sun,2013-07-11,32,40,10,13.0,2.0,-8
YouGov/Sun,2013-07-10,32,37,11,12.0,3.0,-5
YouGov/Sun,2013-07-09,31,39,10,13.0,3.0,-8
YouGov/Sun,2013-07-08,34,40,10,10.0,2.0,-6
YouGov/Sunday Times,2013-07-05,33,39,11,12.0,2.0,-6
YouGov/Sun,2013-07-04,31,39,11,12.0,2.0,-8
YouGov/Sun,2013-07-03,32,40,9,13.0,2.0,-8
Survation/Daily Mirror,2013-07-03,23,36,10,22.0,4.0,-13
YouGov/Sun,2013-07-02,32,40,9,12.0,3.0,-8
YouGov/Sun,2013-07-01,33,38,8,12.0,2.0,-5
Opinium/Observer,2013-06-28,27,37,7,19.0,3.0,-10
YouGov/Sunday Times,2013-06-28,33,38,11,11.0,2.0,-5
YouGov/Sun,2013-06-27,33,39,10,13.0,3.0,-6
YouGov/Sun,2013-06-26,31,42,11,10.0,3.0,-11
YouGov/Sun,2013-06-25,32,40,11,11.0,2.0,-8
YouGov/Sun,2013-06-24,32,39,9,12.0,3.0,-7
ComRes/Independent,2013-06-23,30,36,10,14.0,5.0,-6
YouGov/Sunday Times,2013-06-21,31,39,10,13.0,3.0,-8
YouGov/Sun,2013-06-20,31,39,11,14.0,2.0,-8
YouGov/Sun,2013-06-19,32,38,10,13.0,2.0,-6
YouGov/Sun,2013-06-18,31,38,10,12.0,2.0,-7
YouGov/Sun,2013-06-17,31,40,10,13.0,2.0,-9
Opinium/Observer,2013-06-14,27,36,7,20.0,3.0,-9
YouGov/Sunday Times,2013-06-14,30,39,10,14.0,2.0,-9
ComRes/Independent on Sunday (O),2013-06-13,26,35,10,19.0,4.0,-9
YouGov/Sun,2013-06-13,32,39,10,12.0,2.0,-7
YouGov/Sun,2013-06-12,30,38,11,12.0,3.0,-8
YouGov/Sun,2013-06-11,30,38,9,16.0,3.0,-8
YouGov/Sun,2013-06-10,28,39,11,15.0,2.0,-11
TNS BMRB/,2013-06-10,27,36,8,19.0,3.0,-9
Ipsos-MORI/Evening Standard,2013-06-10,31,35,10,12.0,4.0,-4
ICM/Guardian,2013-06-09,29,36,12,12.0,2.0,-7
YouGov/Sunday Times,2013-06-07,30,40,9,14.0,2.0,-10
YouGov/Sun,2013-06-06,32,39,10,13.0,3.0,-7
YouGov/Sun,2013-06-05,30,39,10,14.0,3.0,-9
YouGov/Sun,2013-06-04,30,40,10,14.0,2.0,-10
YouGov/Sun,2013-06-03,31,38,10,16.0,2.0,-7
TNS BMRB/,2013-06-03,24,37,10,19.0,3.0,-13
Opinium/Observer,2013-05-31,26,37,6,21.0,4.0,-11
YouGov/Sunday Times,2013-05-31,30,39,10,15.0,2.0,-9
Survation/Sun on Sunday,2013-05-30,25,36,10,20.0,4.0,-11
YouGov/Sun,2013-05-30,30,38,11,14.0,3.0,-8
YouGov/Sun,2013-05-29,30,37,11,14.0,3.0,-7
YouGov/Sun,2013-05-28,29,39,10,15.0,3.0,-10
ComRes/Independent,2013-05-26,30,34,10,17.0,2.0,-4
Survation/Mail on Sunday,2013-05-24,24,35,10,22.0,4.0,-11
YouGov/Sunday Times,2013-05-24,30,40,10,14.0,2.0,-10
YouGov/Sun,2013-05-23,29,42,11,13.0,2.0,-13
YouGov/Sun,2013-05-22,27,38,10,16.0,4.0,-11
YouGov/Sun,2013-05-21,27,38,10,16.0,4.0,-11
YouGov/Sun,2013-05-20,31,39,10,14.0,2.0,-8
Survation/,2013-05-18,24,35,11,22.0,,-11
YouGov/Sunday Times,2013-05-17,29,40,9,14.0,3.0,-11
ComRes/Independent on Sunday (O),2013-05-16,29,35,8,19.0,4.0,-6
TNS BMRB/,2013-05-16,28,37,7,18.0,4.0,-9
Opinium/Observer,2013-05-16,27,37,7,20.0,4.0,-10
YouGov/Sun,2013-05-16,31,39,9,15.0,2.0,-8
YouGov/Sun,2013-05-15,30,40,10,14.0,2.0,-10
YouGov/Sun,2013-05-14,30,40,10,15.0,2.0,-10
YouGov/Sun,2013-05-13,31,38,10,14.0,2.0,-7
Ipsos-MORI/Evening Standard,2013-05-13,31,34,10,13.0,6.0,-3
ICM/Guardian,2013-05-12,28,34,11,18.0,2.0,-6
YouGov/Sunday Times,2013-05-10,30,39,9,16.0,3.0,-9
YouGov/Sun,2013-05-09,30,39,10,14.0,2.0,-9
YouGov/Sun,2013-05-08,27,38,11,17.0,2.0,-11
YouGov/Sun,2013-05-07,29,39,9,16.0,2.0,-10
YouGov/Sunday Times,2013-05-03,30,40,11,12.0,2.0,-10
YouGov/Sun,2013-05-02,32,43,9,10.0,1.0,-11
Opinium/Observer,2013-05-02,28,35,9,17.0,4.0,-7
YouGov/Sun,2013-05-01,33,39,10,13.0,2.0,-6
YouGov/Sun,2013-04-30,30,39,11,14.0,2.0,-9
YouGov/Sun,2013-04-29,30,39,11,14.0,3.0,-9
ComRes/Independent,2013-04-28,32,38,9,13.0,4.0,-6
Survation/Free Speech Network,2013-04-28,29,36,12,16.0,3.0,-7
YouGov/Sunday Times,2013-04-26,31,40,11,11.0,3.0,-9
YouGov/Sun,2013-04-25,32,40,11,12.0,2.0,-8
YouGov/Sun,2013-04-24,31,39,10,11.0,3.0,-8
YouGov/Sun,2013-04-23,33,40,10,12.0,3.0,-7
YouGov/Sun,2013-04-22,32,39,11,13.0,2.0,-7
YouGov/Sunday Times,2013-04-19,32,40,11,10.0,2.0,-8
Opinium/Observer,2013-04-18,29,35,8,17.0,4.0,-6
YouGov/Sun,2013-04-18,33,40,10,11.0,2.0,-7
YouGov/Sun,2013-04-17,30,41,10,12.0,2.0,-11
YouGov/Sun,2013-04-16,33,40,10,11.0,2.0,-7
YouGov/Sun,2013-04-15,31,39,12,12.0,2.0,-8
Ipsos-MORI/Evening Standard,2013-04-15,29,38,10,15.0,4.0,-9
ICM/Guardian,2013-04-14,32,38,15,9.0,2.0,-6
Angus Reid/,2013-04-13,27,39,8,16.0,3.0,-12
YouGov/Sunday Times,2013-04-12,31,42,12,11.0,2.0,-11
ComRes/Independent on Sunday (O),2013-04-11,30,38,8,15.0,3.0,-8
YouGov/Sun,2013-04-11,32,42,9,11.0,2.0,-10
YouGov/Sun,2013-04-10,28,42,12,11.0,2.0,-14
YouGov/Sun,2013-04-09,33,41,10,10.0,2.0,-8
YouGov/Sun,2013-04-08,30,40,12,12.0,2.0,-10
TNS BMRB/,2013-04-08,25,40,10,14.0,4.0,-15
YouGov/Sunday Times,2013-04-05,30,40,11,13.0,2.0,-10
Opinium/Observer,2013-04-04,28,38,8,17.0,3.0,-10
YouGov/Sun,2013-04-04,30,42,11,12.0,2.0,-12
YouGov/Sun,2013-04-03,33,41,9,11.0,2.0,-8
YouGov/Sun,2013-04-02,30,43,11,10.0,3.0,-13
YouGov/Sun,2013-03-28,29,42,11,13.0,2.0,-13
YouGov/Sun,2013-03-27,30,40,12,13.0,2.0,-10
YouGov/Sun,2013-03-26,30,39,13,12.0,2.0,-9
YouGov/Sun,2013-03-25,30,41,13,11.0,2.0,-11
TNS BMRB/,2013-03-25,27,37,10,17.0,3.0,-10
ComRes/Independent,2013-03-24,28,38,12,14.0,3.0,-10
YouGov/Sunday Times,2013-03-22,30,41,12,12.0,2.0,-11
Opinium/Observer,2013-03-21,28,38,9,16.0,2.0,-10
YouGov/Sun,2013-03-21,32,41,11,10.0,2.0,-9
YouGov/Sun,2013-03-20,30,41,11,12.0,1.0,-11
YouGov/Sun,2013-03-19,31,41,11,11.0,2.0,-10
YouGov/Sun,2013-03-18,32,40,11,10.0,2.0,-8
TNS BMRB/,2013-03-18,26,39,13,13.0,1.0,-13
YouGov/Sunday Times,2013-03-15,29,41,12,12.0,2.0,-12
ComRes/Independent on Sunday (O),2013-03-14,28,37,9,17.0,4.0,-9
YouGov/Sun,2013-03-14,30,42,11,11.0,2.0,-12
YouGov/Sun,2013-03-13,31,40,11,12.0,3.0,-9
YouGov/Sun,2013-03-12,29,43,11,12.0,1.0,-14
YouGov/Sun,2013-03-11,32,40,11,11.0,1.0,-8
TNS BMRB/,2013-03-11,25,38,11,15.0,3.0,-13
Ipsos-MORI/Evening Standard,2013-03-11,27,40,11,13.0,4.0,-13
ICM/Guardian,2013-03-10,31,39,15,7.0,2.0,-8
YouGov/Sunday Times,2013-03-08,31,41,12,11.0,1.0,-10
Opinium/Observer,2013-03-07,27,39,8,17.0,3.0,-12
YouGov/Sun,2013-03-07,32,41,11,11.0,2.0,-9
YouGov/Sun,2013-03-06,31,41,11,12.0,2.0,-10
YouGov/Sun,2013-03-05,29,42,11,12.0,2.0,-13
YouGov/Sun,2013-03-04,31,40,12,12.0,1.0,-9
TNS BMRB/,2013-03-04,29,38,11,14.0,3.0,-9
YouGov/Sunday Times,2013-03-01,31,42,10,11.0,2.0,-11
YouGov/Sun,2013-02-28,29,42,12,11.0,2.0,-13
YouGov/Sun,2013-02-27,32,43,11,8.0,1.0,-11
YouGov/Sun,2013-02-26,32,42,12,9.0,1.0,-10
YouGov/Sun,2013-02-25,32,44,10,8.0,2.0,-12
ComRes/Independent,2013-02-24,31,43,8,9.0,4.0,-12
YouGov/Sunday Times,2013-02-22,32,43,11,9.0,2.0,-11
Opinium/Observer,2013-02-21,29,41,8,13.0,2.0,-12
YouGov/Sun,2013-02-21,31,45,11,9.0,2.0,-14
YouGov/Sun,2013-02-20,33,43,9,10.0,2.0,-10
YouGov/Sun,2013-02-19,29,44,11,11.0,1.0,-15
YouGov/Sun,2013-02-18,32,41,12,8.0,2.0,-9
TNS BMRB/,2013-02-18,29,38,11,12.0,3.0,-9
YouGov/Sunday Times,2013-02-15,32,43,12,9.0,1.0,-11
ComRes/Independent on Sunday (O),2013-02-14,31,36,8,14.0,4.0,-5
YouGov/Sun,2013-02-14,31,42,11,10.0,2.0,-11
YouGov/Sun,2013-02-13,32,42,9,9.0,3.0,-10
YouGov/Sun,2013-02-12,32,43,10,9.0,2.0,-11
YouGov/Sun,2013-02-11,32,43,10,9.0,2.0,-11
Ipsos-MORI/Evening Standard,2013-02-11,30,42,7,9.0,4.0,-12
TNS BMRB/,2013-02-11,31,41,10,10.0,3.0,-10
ICM/Guardian,2013-02-10,29,41,13,9.0,2.0,-12
YouGov/Sunday Times,2013-02-08,32,41,11,9.0,2.0,-9
Opinium/Observer,2013-02-07,29,39,8,14.0,4.0,-10
YouGov/Sun,2013-02-07,33,41,11,9.0,2.0,-8
YouGov/Sun,2013-02-06,31,42,12,9.0,1.0,-11
YouGov/Sun,2013-02-05,32,42,11,8.0,2.0,-10
YouGov/Sun,2013-02-04,30,45,11,9.0,2.0,-15
TNS BMRB/,2013-02-04,28,41,10,11.0,3.0,-13
YouGov/Sunday Times,2013-02-01,34,41,12,8.0,1.0,-7
YouGov/Sun,2013-01-31,32,44,10,8.0,2.0,-12
YouGov/Sun,2013-01-30,33,42,10,7.0,2.0,-9
YouGov/Sun,2013-01-29,33,42,11,8.0,2.0,-9
YouGov/Sun,2013-01-28,35,41,10,9.0,2.0,-6
ComRes/Independent,2013-01-27,32,39,10,10.0,5.0,-7
ComRes/Independent on Sunday (O),2013-01-25,33,39,11,10.0,2.0,-6
Survation/Mail on Sunday,2013-01-25,31,38,10,14.0,2.0,-7
Angus Reid/Sunday Express,2013-01-25,30,39,10,12.0,3.0,-9
YouGov/Sunday Times,2013-01-25,35,41,12,7.0,1.0,-6
YouGov/Sun,2013-01-24,33,43,10,9.0,2.0,-10
Opinium/Observer,2013-01-24,28,41,8,14.0,3.0,-13
TNS BMRB/,2013-01-24,31,41,8,12.0,3.0,-10
YouGov/Sun,2013-01-23,31,43,11,10.0,2.0,-12
YouGov/Sun,2013-01-22,31,41,12,10.0,2.0,-10
YouGov/Sun,2013-01-21,33,42,10,10.0,2.0,-9
ICM/Guardian,2013-01-20,33,38,15,6.0,2.0,-5
YouGov/Sunday Times,2013-01-18,33,42,11,7.0,2.0,-9
YouGov/Sun,2013-01-17,34,44,9,8.0,2.0,-10
YouGov/Sun,2013-01-16,33,42,12,8.0,2.0,-9
YouGov/Sun,2013-01-15,32,44,10,9.0,2.0,-12
YouGov/Sun,2013-01-14,31,44,11,9.0,2.0,-13
TNS BMRB/,2013-01-14,31,37,9,13.0,3.0,-6
Ipsos-MORI/Evening Standard,2013-01-14,30,43,8,9.0,3.0,-13
Opinium/Observer,2013-01-11,31,41,7,12.0,2.0,-10
Angus Reid/,2013-01-11,27,42,10,11.0,3.0,-15
YouGov/Sunday Times,2013-01-11,31,44,11,8.0,2.0,-13
YouGov/Sun,2013-01-10,31,42,11,10.0,2.0,-11
YouGov/Sun,2013-01-09,33,43,10,10.0,1.0,-10
YouGov/Sun,2013-01-08,32,44,10,9.0,2.0,-12
YouGov/Sun,2013-01-07,32,41,11,9.0,2.0,-9
TNS BMRB/,2013-01-07,29,39,10,12.0,3.0,-10
Survation/Mail on Sunday,2013-01-04,29,38,11,16.0,3.0,-9
YouGov/Sunday Times,2013-01-04,32,43,10,9.0,2.0,-11
YouGov/Sun,2013-01-03,32,43,10,9.0,2.0,-11
YouGov/Sun,2013-01-02,31,43,11,9.0,2.0,-12
Opinium/Observer,2012-12-27,29,39,8,15.0,4.0,-10
ICM/Guardian,2012-12-23,32,40,13,7.0,3.0,-8
YouGov/Sunday Times,2012-12-21,33,43,10,8.0,1.0,-10
YouGov/Sun,2012-12-20,33,41,11,10.0,2.0,-8
YouGov/Sun,2012-12-19,30,43,11,10.0,3.0,-13
YouGov/Sun,2012-12-18,32,43,9,10.0,2.0,-11
YouGov/Sun,2012-12-17,31,43,9,11.0,2.0,-12
TNS BMRB/,2012-12-17,30,40,7,12.0,4.0,-10
Populus/Times,2012-12-16,29,40,11,11.0,3.0,-11
ComRes/Independent,2012-12-16,31,42,10,9.0,4.0,-11
Survation/Mail on Sunday,2012-12-14,30,38,9,14.0,2.0,-8
ComRes/Independent on Sunday (O),2012-12-14,28,39,9,14.0,4.0,-11
YouGov/Sunday Times,2012-12-14,33,45,9,8.0,2.0,-12
Opinium/Observer,2012-12-13,29,39,8,14.0,4.0,-10
YouGov/Sun,2012-12-13,33,43,9,10.0,2.0,-10
YouGov/Sun,2012-12-12,31,44,12,9.0,2.0,-13
YouGov/Sun,2012-12-11,31,43,10,9.0,2.0,-12
YouGov/Sun,2012-12-10,33,42,10,8.0,2.0,-9
Ipsos-MORI/Evening Standard,2012-12-10,35,44,9,7.0,3.0,-9
TNS BMRB/,2012-12-10,26,41,8,16.0,3.0,-15
YouGov/Sunday Times,2012-12-07,33,42,10,9.0,2.0,-9
YouGov/Sun,2012-12-06,32,42,10,9.0,2.0,-10
YouGov/Sun,2012-12-05,32,44,9,10.0,2.0,-12
YouGov/Sun,2012-12-04,30,44,11,10.0,1.0,-14
YouGov/Sun,2012-12-03,31,43,11,10.0,2.0,-12
TNS BMRB/,2012-12-03,28,40,10,12.0,2.0,-12
YouGov/Sunday Times,2012-12-01,31,44,10,10.0,2.0,-13
Angus Reid/,2012-11-29,28,42,10,11.0,3.0,-14
Opinium/Observer,2012-11-29,29,38,9,13.0,3.0,-9
YouGov/Sun,2012-11-29,32,42,10,10.0,2.0,-10
YouGov/Sun,2012-11-28,32,44,11,8.0,2.0,-12
YouGov/Sun,2012-11-27,31,43,9,11.0,2.0,-12
YouGov/Sun,2012-11-26,34,43,9,8.0,1.0,-9
TNS BMRB/,2012-11-25,31,41,8,10.0,3.0,-10
ComRes/Independent,2012-11-25,35,42,10,6.0,3.0,-7
YouGov/Sunday Times,2012-11-23,33,44,9,8.0,2.0,-11
YouGov/Sun,2012-11-22,31,43,10,9.0,2.0,-12
YouGov/Sun,2012-11-21,33,41,9,10.0,3.0,-8
YouGov/Sun,2012-11-20,33,42,10,8.0,2.0,-9
YouGov/Sun,2012-11-19,32,42,9,9.0,2.0,-10
ICM/Guardian,2012-11-18,32,40,13,7.0,2.0,-8
TNS BMRB/,2012-11-16,31,39,11,7.0,4.0,-8
YouGov/Sunday Times,2012-11-16,33,44,9,8.0,2.0,-11
ComRes/Independent on Sunday (O),2012-11-16,31,43,10,8.0,2.0,-12
YouGov/Sun,2012-11-15,33,43,8,9.0,2.0,-10
Opinium/Observer,2012-11-15,32,39,8,10.0,3.0,-7
YouGov/Sun,2012-11-14,35,42,8,7.0,3.0,-7
YouGov/Sun,2012-11-13,34,44,9,7.0,2.0,-10
Ipsos-MORI/Evening Standard,2012-11-13,32,46,9,3.0,4.0,-14
YouGov/Sun,2012-11-12,35,39,10,8.0,2.0,-4
TNS BMRB/,2012-11-12,31,41,9,9.0,3.0,-10
YouGov/Sunday Times,2012-11-09,32,44,8,8.0,2.0,-12
YouGov/Sun,2012-11-08,33,44,9,7.0,2.0,-11
YouGov/Sun,2012-11-07,34,45,8,6.0,3.0,-11
YouGov/Sun,2012-11-06,35,42,9,7.0,2.0,-7
YouGov/Sun,2012-11-05,35,44,8,7.0,2.0,-9
TNS BMRB/,2012-11-05,31,42,9,8.0,3.0,-11
YouGov/Sunday Times,2012-11-02,35,42,9,7.0,2.0,-7
Opinium/Observer,2012-11-01,30,41,9,10.0,3.0,-11
YouGov/Sun,2012-11-01,33,44,9,7.0,3.0,-11
YouGov/Sun,2012-10-31,33,44,9,8.0,2.0,-11
YouGov/Sun,2012-10-30,32,44,9,8.0,2.0,-12
YouGov/Sun,2012-10-29,33,43,9,8.0,2.0,-10
ComRes/Independent,2012-10-29,33,44,12,5.0,3.0,-11
TNS BMRB/,2012-10-29,31,42,11,8.0,2.0,-11
YouGov/Sunday Times,2012-10-26,35,42,9,7.0,3.0,-7
YouGov/Sun,2012-10-25,33,44,10,6.0,2.0,-11
Ipsos-MORI/Evening Standard,2012-10-24,33,43,9,6.0,3.0,-10
YouGov/Sun,2012-10-24,33,43,9,8.0,2.0,-10
YouGov/Sun,2012-10-23,34,42,9,8.0,2.0,-8
YouGov/Sun,2012-10-22,32,45,8,8.0,3.0,-13
ICM/Guardian,2012-10-22,33,41,14,5.0,2.0,-8
TNS BMRB/,2012-10-22,30,44,8,7.0,3.0,-14
Populus/Times,2012-10-21,35,40,9,5.0,4.0,-5
Survation/Mail on Sunday,2012-10-20,30,43,8,12.0,,-13
YouGov/Sunday Times,2012-10-19,32,43,9,9.0,2.0,-11
ComRes/Independent on Sunday (O),2012-10-18,33,41,10,9.0,3.0,-8
YouGov/Sun,2012-10-18,34,42,10,9.0,2.0,-8
Opinium/Observer,2012-10-18,31,40,9,10.0,4.0,-9
YouGov/Sun,2012-10-17,33,42,9,7.0,3.0,-9
YouGov/Sun,2012-10-16,34,43,9,7.0,2.0,-9
YouGov/Sun,2012-10-15,34,43,9,7.0,3.0,-9
TNS BMRB/,2012-10-15,29,42,7,10.0,4.0,-13
Angus Reid/Sunday Express,2012-10-12,31,43,8,8.0,3.0,-12
YouGov/Sunday Times,2012-10-12,33,43,10,6.0,2.0,-10
YouGov/Sun,2012-10-11,35,42,8,7.0,2.0,-7
YouGov/Sun,2012-10-10,34,41,8,10.0,2.0,-7
YouGov/Sun,2012-10-09,33,45,9,6.0,3.0,-12
YouGov/Sun,2012-10-08,34,44,8,7.0,2.0,-10
TNS BMRB/,2012-10-08,31,44,8,8.0,4.0,-13
YouGov/Sunday Times,2012-10-05,31,45,8,8.0,3.0,-14
Opinium/Observer,2012-10-04,30,41,9,11.0,4.0,-11
YouGov/Sun,2012-10-04,32,43,10,8.0,2.0,-11
YouGov/Sun,2012-10-03,31,45,10,7.0,2.0,-14
YouGov/Sun,2012-10-02,34,42,9,8.0,2.0,-8
YouGov/Sun,2012-10-01,34,43,9,8.0,3.0,-9
ComRes/Independent,2012-09-30,35,38,15,4.0,3.0,-3
Opinium/Observer,2012-09-28,29,39,10,10.0,4.0,-10
YouGov/Sunday Times,2012-09-28,35,40,10,7.0,3.0,-5
YouGov/Sun,2012-09-27,31,43,11,8.0,4.0,-12
YouGov/Sun,2012-09-26,32,41,9,9.0,3.0,-9
YouGov/Sun,2012-09-25,31,44,9,9.0,3.0,-13
YouGov/Sun,2012-09-24,32,43,9,7.0,3.0,-11
ICM/Guardian,2012-09-23,31,41,14,6.0,3.0,-10
TNS BMRB/,2012-09-21,28,44,8,7.0,5.0,-16
Opinium/Observer,2012-09-21,30,42,8,10.0,4.0,-12
Survation/Mail on Sunday,2012-09-21,29,41,10,12.0,3.0,-12
ComRes/Independent on Sunday (O),2012-09-21,35,39,10,8.0,2.0,-4
YouGov/Sunday Times,2012-09-21,34,43,8,8.0,2.0,-9
YouGov/Sun,2012-09-20,35,41,9,7.0,3.0,-6
Survation/Mirror,2012-09-20,30,40,10,12.0,,-10
YouGov/Sun,2012-09-19,33,45,10,7.0,2.0,-12
YouGov/Sun,2012-09-18,34,43,8,8.0,3.0,-9
Ipsos-MORI/Sky News/Evening Standard,2012-09-17,30,41,13,8.0,4.0,-11
YouGov/Sun,2012-09-17,33,45,10,5.0,2.0,-12
Populus/Times,2012-09-16,30,45,10,6.0,4.0,-15
YouGov/Sunday Times,2012-09-14,34,44,9,7.0,3.0,-10
YouGov/Sun,2012-09-13,34,43,8,7.0,3.0,-9
TNS BMRB/,2012-09-13,31,43,9,5.0,4.0,-12
Opinium/,2012-09-12,32,40,10,9.0,3.0,-8
YouGov/Sun,2012-09-12,33,42,11,7.0,1.0,-9
YouGov/Sun,2012-09-11,31,44,9,8.0,3.0,-13
YouGov/Sun,2012-09-10,31,42,10,8.0,2.0,-11
TNS BMRB/,2012-09-10,30,41,12,7.0,4.0,-11
YouGov/Sunday Times,2012-09-07,33,43,10,7.0,2.0,-10
YouGov/Sun,2012-09-06,33,45,8,6.0,3.0,-12
YouGov/Sun,2012-09-05,33,45,8,7.0,2.0,-12
YouGov/Sun,2012-09-04,34,40,10,7.0,3.0,-6
Opinium/,2012-09-03,31,42,8,9.0,3.0,-11
TNS BMRB/,2012-09-03,31,43,10,6.0,3.0,-12
YouGov/Sun,2012-09-03,33,44,8,7.0,2.0,-11
ComRes/Independent,2012-09-02,35,42,12,3.0,3.0,-7
YouGov/Sunday Times,2012-08-31,35,41,9,7.0,2.0,-6
YouGov/Sun,2012-08-30,33,42,10,8.0,2.0,-9
YouGov/Sun,2012-08-29,32,44,9,6.0,3.0,-12
YouGov/Sun,2012-08-28,32,44,10,8.0,3.0,-12
TNS BMRB/,2012-08-27,31,40,11,5.0,4.0,-9
ICM/Guardian,2012-08-26,34,39,15,4.0,2.0,-5
Survation/Mail on Sunday,2012-08-24,30,37,10,12.0,5.0,-7
YouGov/Sunday Times,2012-08-24,34,43,10,6.0,1.0,-9
YouGov/Sun,2012-08-23,32,44,10,7.0,3.0,-12
YouGov/Sun,2012-08-22,33,42,10,6.0,2.0,-9
YouGov/Sun,2012-08-21,34,44,8,8.0,2.0,-10
YouGov/Sun,2012-08-20,34,44,8,7.0,3.0,-10
TNS BMRB/,2012-08-20,32,42,10,7.0,3.0,-10
YouGov/Sunday Times,2012-08-17,32,43,10,7.0,2.0,-11
ComRes/Independent on Sunday (O),2012-08-16,33,42,10,8.0,2.0,-9
YouGov/Sun,2012-08-16,35,44,8,6.0,2.0,-9
YouGov/Sun,2012-08-15,34,43,10,6.0,2.0,-9
Angus Reid/,2012-08-15,30,41,11,9.0,3.0,-11
Ipsos-MORI/Evening Standard,2012-08-15,32,42,11,4.0,4.0,-10
YouGov/Sun,2012-08-14,34,44,10,7.0,1.0,-10
YouGov/Sun,2012-08-13,34,42,9,6.0,3.0,-8
YouGov/Sunday Times,2012-08-10,34,42,8,8.0,2.0,-8
Opinium/,2012-08-09,31,40,10,10.0,3.0,-9
YouGov/Sun,2012-08-09,33,43,9,9.0,3.0,-10
YouGov/Sun,2012-08-08,33,42,11,6.0,2.0,-9
YouGov/Sun,2012-08-07,33,44,9,8.0,2.0,-11
YouGov/Sun,2012-08-06,34,44,10,6.0,2.0,-10
YouGov/Sunday Times,2012-08-03,32,44,10,8.0,2.0,-12
YouGov/Sun,2012-08-02,33,44,8,9.0,2.0,-11
YouGov/Sun,2012-08-01,32,43,10,8.0,2.0,-11
YouGov/Sun,2012-07-31,34,42,10,6.0,2.0,-8
YouGov/Sun,2012-07-30,33,44,9,7.0,2.0,-11
ComRes/Independent,2012-07-29,33,44,10,4.0,4.0,-11
YouGov/Sunday Times,2012-07-27,33,42,9,8.0,3.0,-9
TNS BMRB/,2012-07-26,30,42,11,,,-12
YouGov/Sun,2012-07-26,33,42,9,8.0,3.0,-9
YouGov/Sun,2012-07-25,33,44,9,7.0,2.0,-11
YouGov/Sun,2012-07-24,33,44,9,7.0,3.0,-11
YouGov/Sun,2012-07-23,33,43,9,8.0,1.0,-10
ICM/Guardian,2012-07-22,34,39,14,4.0,4.0,-5
YouGov/Sunday Times,2012-07-20,34,43,11,7.0,3.0,-9
ComRes/Independent on Sunday (O),2012-07-19,32,42,10,9.0,3.0,-10
YouGov/Sun,2012-07-19,34,42,9,7.0,2.0,-8
YouGov/Sun,2012-07-18,33,43,8,7.0,2.0,-9
YouGov/Sun,2012-07-17,34,43,8,7.0,2.0,-9
Opinium/,2012-07-16,32,41,9,8.0,4.0,-9
YouGov/Sun,2012-07-16,33,44,9,8.0,2.0,-11
Ipsos-MORI/Evening Standard,2012-07-16,31,44,12,5.0,3.0,-13
Populus/Times,2012-07-15,34,40,12,5.0,2.0,-6
YouGov/Sunday Times,2012-07-13,34,43,9,7.0,3.0,-9
YouGov/Sun,2012-07-12,34,42,9,7.0,3.0,-8
YouGov/Sun,2012-07-11,35,42,9,8.0,2.0,-7
YouGov/Sun,2012-07-10,33,43,11,6.0,3.0,-10
YouGov/Sun,2012-07-09,35,44,7,6.0,3.0,-9
YouGov/Sunday Times,2012-07-06,32,43,8,8.0,3.0,-11
Opinium/,2012-07-05,30,40,9,9.0,4.0,-10
YouGov/Sun,2012-07-05,35,43,8,8.0,2.0,-8
YouGov/Sun,2012-07-04,33,44,8,7.0,3.0,-11
YouGov/Sun,2012-07-03,35,42,10,7.0,2.0,-7
YouGov/Sun,2012-07-02,34,44,8,8.0,2.0,-10
ComRes/Independent,2012-07-01,33,42,13,3.0,3.0,-9
YouGov/Sunday Times,2012-06-29,34,43,9,6.0,2.0,-9
Opinium/,2012-06-28,31,42,8,9.0,4.0,-11
YouGov/Sun,2012-06-28,32,43,10,7.0,3.0,-11
YouGov/Sun,2012-06-27,31,45,9,7.0,2.0,-14
YouGov/Sun,2012-06-26,34,42,11,7.0,2.0,-8
YouGov/Sun,2012-06-25,32,43,11,7.0,1.0,-11
ICM/Guardian,2012-06-24,34,39,14,3.0,3.0,-5
YouGov/Sunday Times,2012-06-22,34,43,9,8.0,2.0,-9
YouGov/Sun,2012-06-21,33,43,8,8.0,2.0,-10
YouGov/Sun,2012-06-20,34,41,10,8.0,3.0,-7
YouGov/Sun,2012-06-19,34,44,7,6.0,2.0,-10
YouGov/Sun,2012-06-18,33,44,7,8.0,2.0,-11
TNS BMRB/,2012-06-18,32,40,10,9.0,,-8
Populus/Times,2012-06-17,33,41,9,5.0,,-8
ComRes/Independent on Sunday (O),2012-06-15,32,42,9,8.0,,-10
YouGov/Sunday Times,2012-06-15,32,44,9,8.0,,-12
YouGov/Sun,2012-06-14,31,43,9,8.0,,-12
YouGov/Sun,2012-06-13,31,43,9,9.0,,-12
YouGov/Sun,2012-06-12,33,43,8,8.0,,-10
YouGov/Sun,2012-06-11,31,45,9,9.0,,-14
Ipsos-MORI/Evening Standard,2012-06-11,31,40,10,6.0,,-9
Opinium/,2012-06-11,31,42,9,8.0,,-11
YouGov/Sunday Times,2012-06-08,34,42,7,9.0,,-8
YouGov/Sun,2012-06-07,34,43,8,6.0,,-9
YouGov/Sun,2012-06-06,34,43,8,7.0,,-9
YouGov/Sunday Times,2012-06-01,32,42,8,7.0,,-10
Survation/,2012-06-01,29,37,13,12.0,,-8
Angus Reid/,2012-05-31,29,45,9,8.0,,-16
YouGov/Sun,2012-05-31,31,45,9,8.0,,-14
YouGov/Sun,2012-05-30,32,44,9,7.0,,-12
YouGov/Sun,2012-05-29,32,45,8,8.0,,-13
YouGov/Sun,2012-05-28,33,44,8,7.0,,-11
ComRes/Independent,2012-05-28,34,42,11,4.0,,-8
YouGov/Sunday Times,2012-05-25,31,43,8,8.0,,-12
YouGov/Sun,2012-05-24,34,42,8,7.0,,-8
YouGov/Sun,2012-05-23,32,42,9,9.0,,-10
YouGov/Sun,2012-05-22,32,43,8,9.0,,-11
TNS BMRB/,2012-05-21,30,41,9,10.0,,-11
YouGov/Sun,2012-05-21,32,44,7,8.0,,-12
Populus/Times,2012-05-20,33,41,10,5.0,,-8
ICM/Guardian,2012-05-20,36,41,11,4.0,,-5
YouGov/Sunday Times,2012-05-18,32,43,8,9.0,,-11
ComRes/Independent on Sunday (O),2012-05-17,32,41,11,7.0,,-9
Opinium/,2012-05-17,30,41,9,10.0,,-11
YouGov/Sun,2012-05-17,31,44,7,9.0,,-13
YouGov/Sun,2012-05-16,31,45,9,8.0,,-14
YouGov/Sun,2012-05-15,32,43,8,9.0,,-11
YouGov/Sun,2012-05-14,31,45,7,8.0,,-14
Ipsos-MORI/Evening Standard,2012-05-14,33,43,9,6.0,,-10
YouGov/Sunday Times,2012-05-11,31,43,10,8.0,,-12
YouGov/Sun,2012-05-10,34,44,7,7.0,,-10
YouGov/Sun,2012-05-09,31,44,9,8.0,,-13
YouGov/Sun,2012-05-08,31,44,8,8.0,,-13
TNS BMRB/,2012-05-07,30,43,10,,,-13
YouGov/Sunday Times,2012-05-04,31,43,9,8.0,,-12
YouGov/Sun,2012-05-03,32,41,9,9.0,,-9
YouGov/Sun,2012-05-02,33,43,8,8.0,,-10
YouGov/Sun,2012-05-01,32,41,9,8.0,,-9
YouGov/Sun,2012-04-30,35,42,8,7.0,,-7
Opinium/,2012-04-30,32,39,8,10.0,,-7
Survation/Daily Mirror,2012-04-27,30,37,13,9.0,,-7
ComRes/Independent (O),2012-04-27,34,39,10,9.0,,-5
YouGov/Sunday Times,2012-04-27,29,40,11,10.0,,-11
YouGov/Sun,2012-04-26,31,43,9,9.0,,-12
YouGov/Sun,2012-04-25,32,43,9,8.0,,-11
YouGov/Sun,2012-04-24,32,43,8,8.0,,-11
YouGov/Sun,2012-04-23,32,45,8,7.0,,-13
Opinium/,2012-04-23,31,38,11,8.0,,-7
Ipsos-MORI/Evening Standard,2012-04-23,35,38,12,4.0,,-3
ICM/Guardian,2012-04-22,33,41,15,3.0,,-8
YouGov/Sunday Times,2012-04-20,33,41,11,8.0,,-8
ComRes/Independent on Sunday (O),2012-04-19,34,40,11,6.0,,-6
YouGov/Sun,2012-04-19,32,45,8,7.0,,-13
YouGov/Sun,2012-04-18,32,41,10,8.0,,-9
YouGov/Sun,2012-04-17,32,41,8,9.0,,-9
Opinium/,2012-04-16,32,37,9,10.0,,-5
YouGov/Sun,2012-04-16,32,43,8,9.0,,-11
Populus/Times,2012-04-15,33,42,11,4.0,,-9
Angus Reid/,2012-04-13,29,41,11,8.0,,-12
YouGov/Sunday Times,2012-04-13,33,39,10,,,-6
YouGov/Sun,2012-04-12,35,41,9,,,-6
TNS BMRB/,2012-04-11,32,42,10,,,-10
YouGov/Sun,2012-04-11,35,41,8,,,-6
YouGov/Sun,2012-04-10,36,40,9,,,-4
Survation/Mail on Sunday,2012-04-06,30,35,11,,,-5
YouGov/Sun,2012-04-05,33,42,8,,,-9
YouGov/Sun,2012-04-04,32,42,9,,,-10
YouGov/Sun,2012-04-03,34,42,8,,,-8
YouGov/Sun,2012-04-02,33,43,8,,,-10
YouGov/Sunday Times,2012-03-31,33,42,8,,,-9
YouGov/Sun,2012-03-29,34,44,8,,,-10
YouGov/Sun,2012-03-28,34,44,10,,,-10
YouGov/Sun,2012-03-27,33,43,9,,,-10
YouGov/Sun,2012-03-26,35,42,9,,,-7
ComRes/Independent,2012-03-26,33,43,11,,,-10
Populus/Times,2012-03-25,34,38,11,,,-4
Survation/Mail on Sunday,2012-03-24,31,39,11,,,-8
ICM/Sunday Telegraph,2012-03-23,37,38,13,,,-1
YouGov/Sunday Times,2012-03-23,35,42,10,,,-7
YouGov/Sun,2012-03-22,34,42,9,,,-8
Opinium/,2012-03-21,34,39,8,9.0,,-5
YouGov/Sun,2012-03-21,36,41,10,,,-5
YouGov/Sun,2012-03-20,35,43,9,,,-8
Ipsos-MORI/Evening Standard,2012-03-19,36,37,11,,,-1
YouGov/Sun,2012-03-19,36,42,9,,,-6
ICM/Guardian,2012-03-18,39,36,15,,,3
YouGov/Sunday Times,2012-03-16,38,40,9,,,-2
ComRes/Independent on Sunday (O),2012-03-15,37,40,10,,,-3
YouGov/Sun,2012-03-15,37,42,8,,,-5
YouGov/Sun,2012-03-14,38,41,9,,,-3
YouGov/Sun,2012-03-13,36,43,9,,,-7
YouGov/Sun,2012-03-12,36,41,9,,,-5
Opinium/,2012-03-12,38,36,10,,,2
YouGov/Sunday Times,2012-03-09,37,42,9,,,-5
YouGov/Sun,2012-03-08,37,42,8,,,-5
Angus Reid/,2012-03-07,32,40,10,,,-8
YouGov/Sun,2012-03-07,38,41,9,,,-3
YouGov/Sun,2012-03-06,37,41,9,,,-4
YouGov/Sun,2012-03-05,36,41,11,,,-5
TNS BMRB/,2012-03-05,35,38,11,,,-3
YouGov/Sunday Times,2012-03-02,40,39,9,,,1
YouGov/Sun,2012-03-01,39,39,8,,,0
YouGov/Sun,2012-02-29,38,40,9,,,-2
YouGov/Sun,2012-02-28,40,39,9,,,1
YouGov/Sun,2012-02-27,38,40,9,,,-2
Ipsos-MORI/Reuters,2012-02-27,35,41,12,,,-6
ComRes/Independent,2012-02-26,37,40,13,,,-3
YouGov/Sunday Times,2012-02-24,38,40,10,,,-2
Opinium/,2012-02-23,35,39,10,,,-4
YouGov/Sun,2012-02-23,39,38,10,,,1
YouGov/Sun,2012-02-22,38,40,8,,,-2
YouGov/Sun,2012-02-21,37,41,9,,,-4
YouGov/Sun,2012-02-20,39,38,10,,,1
Populus/Times,2012-02-19,37,39,11,,,-2
ICM/Guardian,2012-02-19,36,37,14,,,-1
YouGov/Sunday Times,2012-02-17,37,41,7,,,-4
ComRes/Independent on Sunday (O),2012-02-16,39,38,10,,,1
YouGov/Sun,2012-02-16,39,39,9,,,0
YouGov/Sun,2012-02-15,39,40,9,,,-1
YouGov/Sun,2012-02-14,40,39,9,,,1
YouGov/Sun,2012-02-13,38,42,9,,,-4
Opinium/,2012-02-13,36,36,10,,,0
YouGov/Sunday Times,2012-02-10,38,39,9,,,-1
YouGov/Sun,2012-02-09,38,41,9,,,-3
YouGov/Sun,2012-02-08,40,38,10,,,2
YouGov/Sun,2012-02-07,37,42,9,,,-5
YouGov/Sun,2012-02-06,41,40,8,,,1
YouGov/Sunday Times,2012-02-03,39,40,9,,,-1
YouGov/Sun,2012-02-02,39,41,8,,,-2
YouGov/Sun,2012-02-01,38,40,8,,,-2
YouGov/Sun,2012-01-31,39,40,9,,,-1
YouGov/Sun,2012-01-30,40,38,10,,,2
Opinium/,2012-01-30,38,36,8,,,2
ComRes/Independent,2012-01-29,37,38,14,,,-1
YouGov/Sunday Times,2012-01-27,39,40,8,,,-1
YouGov/Sun,2012-01-26,39,40,9,,,-1
YouGov/Sun,2012-01-25,38,40,9,,,-2
YouGov/Sun,2012-01-24,40,38,9,,,2
TNS BMRB/,2012-01-23,37,40,10,,,-3
Angus Reid/,2012-01-23,35,37,11,,,-2
YouGov/Sun,2012-01-23,39,40,8,,,-1
Ipsos-MORI/Reuters,2012-01-23,38,38,12,,,0
Populus/Times,2012-01-22,37,38,13,,,-1
ICM/Guardian,2012-01-22,40,35,16,,,5
YouGov/Sunday Times,2012-01-20,41,36,9,,,5
ComRes/Independent on Sunday (O),2012-01-19,38,38,11,,,0
YouGov/Sun,2012-01-19,41,38,8,,,3
YouGov/Sun,2012-01-18,40,39,7,,,1
YouGov/Sun,2012-01-17,39,40,8,,,-1
YouGov/Sun,2012-01-16,40,40,9,,,0
Opinium/,2012-01-15,37,37,9,,,0
YouGov/Sunday Times,2012-01-13,38,40,9,,,-2
YouGov/Sun,2012-01-12,41,40,8,,,1
YouGov/Sun,2012-01-11,40,38,10,,,2
YouGov/Sun,2012-01-10,40,40,10,,,0
YouGov/Sun,2012-01-09,39,41,10,,,-2
YouGov/Sunday Times,2012-01-06,38,40,11,,,-2
Opinium/,2012-01-05,36,37,9,,,-1
YouGov/Sun,2012-01-05,39,41,11,,,-2
YouGov/Sun,2012-01-04,38,42,10,,,-4
YouGov/Sun,2012-01-03,39,41,9,,,-2
YouGov/Sun,2011-12-22,40,40,9,,,0
ICM/Guardian,2011-12-21,37,36,15,,,1
YouGov/Sun,2011-12-21,40,40,10,,,0
YouGov/Sun,2011-12-20,39,40,10,,,-1
TNS BMRB/,2011-12-19,35,38,11,,,-3
YouGov/Sun,2011-12-19,38,42,9,,,-4
Populus/Times,2011-12-18,35,39,12,,,-4
YouGov/Sunday Times,2011-12-16,39,42,9,,,-3
ICM/Sunday Telegraph,2011-12-15,40,34,14,,,6
YouGov/Sun,2011-12-15,41,40,10,,,1
YouGov/Sun,2011-12-14,40,38,10,,,2
YouGov/Sun,2011-12-13,41,39,10,,,2
Ipsos-MORI/Reuters,2011-12-12,41,39,11,,,2
YouGov/Sun,2011-12-12,39,40,10,,,-1
ComRes/Independent,2011-12-11,38,38,12,,,0
Survation/Mail on Sunday,2011-12-10,35,35,14,,,0
YouGov/Sunday Times,2011-12-09,38,39,11,,,-1
ComRes/Independent on Sunday (O),2011-12-08,36,40,10,,,-4
YouGov/Sun,2011-12-08,36,41,10,,,-5
YouGov/Sun,2011-12-07,35,42,9,,,-7
YouGov/Sun,2011-12-06,37,41,10,,,-4
YouGov/Sun,2011-12-05,36,42,11,,,-6
BPIX/Mail on Sunday,2011-12-03,36,41,11,,,-5
YouGov/Sunday Times,2011-12-02,35,43,9,,,-8
YouGov/Sun,2011-12-01,36,41,11,,,-5
ICM/Sunday Telegraph,2011-11-30,38,36,14,,,2
YouGov/Sun,2011-11-30,37,42,9,,,-5
YouGov/Sun,2011-11-29,38,41,9,,,-3
YouGov/Sun,2011-11-28,37,39,9,,,-2
TNS BMRB/,2011-11-28,36,39,9,,,-3
ComRes/Independent,2011-11-27,37,39,10,,,-2
Survation/Daily Star,2011-11-25,32,34,12,,,-2
YouGov/Sunday Times,2011-11-25,34,43,11,,,-9
YouGov/Sun,2011-11-24,35,40,9,,,-5
YouGov/Sun,2011-11-23,35,40,11,,,-5
YouGov/Sun,2011-11-22,35,42,9,,,-7
Opinium/,2011-11-21,36,37,9,,,-1
Ipsos-MORI/Reuters,2011-11-21,34,41,12,,,-7
YouGov/Sun,2011-11-21,36,40,9,,,-4
Populus/Times,2011-11-20,33,41,13,,,-8
ICM/Guardian,2011-11-20,36,38,14,,,-2
ComRes/Independent on Sunday (O),2011-11-18,35,39,11,,,-4
YouGov/Sunday Times,2011-11-18,36,40,9,,,-4
YouGov/Sun,2011-11-17,34,40,11,,,-6
YouGov/Sun,2011-11-16,36,41,10,,,-5
YouGov/Sun,2011-11-15,36,42,7,,,-6
YouGov/Sun,2011-11-14,37,40,9,,,-3
YouGov/Sunday Times,2011-11-11,36,41,9,,,-5
YouGov/Sun,2011-11-10,35,42,8,,,-7
YouGov/Sun,2011-11-09,36,40,10,,,-4
Survation/Unite,2011-11-09,38,39,12,,,-1
YouGov/Sun,2011-11-08,35,40,10,,,-5
YouGov/Sun,2011-11-07,36,41,9,,,-5
Opinium/,2011-11-07,34,38,10,,,-4
YouGov/Sunday Times,2011-11-04,35,41,9,,,-6
YouGov/Sun,2011-11-03,36,41,8,,,-5
YouGov/Sun,2011-11-02,37,41,8,,,-4
YouGov/Sun,2011-11-01,35,41,9,,,-6
TNS BMRB/,2011-10-31,36,37,11,,,-1
YouGov/Sun,2011-10-31,39,41,8,,,-2
ComRes/Independent,2011-10-30,34,38,14,,,-4
YouGov/Sunday Times,2011-10-28,36,39,8,,,-3
YouGov/Sun,2011-10-27,35,42,9,,,-7
YouGov/Sun,2011-10-26,35,41,10,,,-6
YouGov/Sun,2011-10-25,36,40,9,,,-4
Ipsos-MORI/Reuters,2011-10-24,34,38,12,,,-4
Opinium/,2011-10-24,33,39,9,,,-6
YouGov/Sun,2011-10-24,36,40,9,,,-4
ICM/Guardian,2011-10-23,35,39,13,,,-4
YouGov/Sunday Times,2011-10-21,36,38,10,,,-2
YouGov/Sun,2011-10-20,36,41,10,,,-5
YouGov/Sun,2011-10-19,35,41,9,,,-6
YouGov/Sun,2011-10-18,38,42,9,,,-4
YouGov/Sun,2011-10-17,37,40,9,,,-3
Populus/Times,2011-10-16,33,41,8,,,-8
YouGov/Sunday Times,2011-10-14,39,42,8,,,-3
ComRes/Independent on Sunday (O),2011-10-13,37,39,10,,,-2
YouGov/Sun,2011-10-13,37,42,9,,,-5
YouGov/Sun,2011-10-12,36,42,9,,,-6
YouGov/Sun,2011-10-11,37,41,8,,,-4
Opinium/,2011-10-10,36,37,8,,,-1
YouGov/Sun,2011-10-10,36,40,11,,,-4
YouGov/Sunday Times,2011-10-07,38,42,9,,,-4
YouGov/Sun,2011-10-06,37,41,10,,,-4
YouGov/Sun,2011-10-05,37,41,9,,,-4
YouGov/Sun,2011-10-04,38,42,9,,,-4
YouGov/Sun,2011-10-03,37,42,9,,,-5
Opinium/,2011-09-30,33,40,9,,,-7
YouGov/Sunday Times,2011-09-30,36,42,10,,,-6
YouGov/Sun,2011-09-29,38,41,9,,,-3
YouGov/Sun,2011-09-28,37,43,9,,,-6
YouGov/Sun,2011-09-27,37,43,8,,,-6
YouGov/Sun,2011-09-26,39,41,8,,,-2
ComRes/Independent,2011-09-24,37,36,12,,,1
YouGov/Sunday Times,2011-09-23,36,42,11,,,-6
YouGov/Sun,2011-09-22,36,42,10,,,-6
ICM/Guardian,2011-09-21,37,38,14,,,-1
YouGov/Sun,2011-09-21,35,41,9,,,-6
YouGov/Sun,2011-09-20,35,41,10,,,-6
YouGov/Sun,2011-09-19,36,42,10,,,-6
ComRes/Independent on Sunday (O),2011-09-16,38,38,11,,,0
YouGov/Sunday Times,2011-09-16,36,42,9,,,-6
Opinium/,2011-09-15,33,36,9,,,0
YouGov/Sun,2011-09-15,38,41,9,,,-3
YouGov/Sun,2011-09-14,37,41,10,,,-4
YouGov/Sun,2011-09-13,35,43,10,,,-8
YouGov/Sun,2011-09-12,37,41,10,,,-4
Ipsos-MORI/Reuters,2011-09-12,35,37,13,,,-2
Populus/Times,2011-09-11,34,38,12,,,-4
YouGov/Sunday Times,2011-09-09,38,41,9,,,-4
YouGov/Sun,2011-09-08,36,42,10,,,-6
YouGov/Sun,2011-09-07,36,42,9,,,-6
YouGov/Sun,2011-09-06,38,40,9,,,-2
YouGov/Sun,2011-09-05,37,43,9,,,-6
Opinium/,2011-09-05,36,37,9,,,-1
ComRes/Independent,2011-09-04,37,38,11,,,-1
Angus Reid/,2011-09-02,33,39,11,,,-6
YouGov/Sunday Times,2011-09-02,38,39,10,,,-1
YouGov/Sun,2011-09-01,36,42,10,,,-6
YouGov/Sun,2011-08-31,37,42,10,,,-5
YouGov/Sun,2011-08-30,39,40,10,,,-1
YouGov/Sunday Times,2011-08-26,38,41,9,,,-3
YouGov/Sun,2011-08-25,37,42,9,,,-5
YouGov/Sun,2011-08-24,36,43,9,,,-7
YouGov/Sun,2011-08-23,37,44,9,,,-7
YouGov/Sun,2011-08-22,35,44,9,,,-9
Ipsos-MORI/Reuters,2011-08-22,34,40,15,,,-6
ICM/Guardian,2011-08-21,37,36,17,,,1
Opinium/,2011-08-19,37,38,9,,,-1
YouGov/Sunday Times,2011-08-19,36,40,11,,,-4
ComRes/Independent on Sunday (O),2011-08-18,38,40,11,,,-2
YouGov/Sun,2011-08-18,36,44,9,,,-8
YouGov/Sun,2011-08-17,35,44,9,,,-9
YouGov/Sun,2011-08-16,36,42,10,,,-6
YouGov/Sun,2011-08-15,35,43,9,,,-8
YouGov/Sunday Times,2011-08-12,36,43,9,,,-7
Opinium/,2011-08-11,34,38,9,,,-4
YouGov/Sun,2011-08-11,35,43,9,,,-8
YouGov/Sun,2011-08-10,36,43,9,,,-7
YouGov/Sun,2011-08-09,36,43,9,,,-7
YouGov/Sun,2011-08-08,36,44,9,,,-8
YouGov/Sunday Times,2011-08-05,35,44,9,,,-9
YouGov/Sun,2011-08-04,36,42,10,,,-6
YouGov/Sun,2011-08-03,35,43,10,,,-8
YouGov/Sun,2011-08-02,36,45,8,,,-9
YouGov/Sun,2011-08-01,35,42,11,,,-7
YouGov/Sunday Times,2011-07-29,35,44,9,,,-9
YouGov/Sun,2011-07-28,36,42,11,,,-6
YouGov/Sun,2011-07-27,36,43,8,,,-7
YouGov/Sun,2011-07-26,35,44,9,,,-9
YouGov/Sun,2011-07-25,37,41,10,,,-4
ComRes/Independent,2011-07-24,34,40,13,,,-6
YouGov/Sunday Times,2011-07-22,35,43,10,,,-8
YouGov/Sun,2011-07-21,36,44,9,,,-8
Angus Reid/,2011-07-20,34,41,10,,,-7
YouGov/Sun,2011-07-20,35,43,11,,,-8
YouGov/Sun,2011-07-19,36,43,8,,,-7
Ipsos-MORI/Reuters,2011-07-18,32,39,11,,,-7
YouGov/Sun,2011-07-18,37,42,9,,,-5
Populus/Times,2011-07-17,34,39,11,,,-5
ICM/Guardian,2011-07-17,37,36,16,,,1
YouGov/Sunday Times,2011-07-15,36,42,11,,,-6
ComRes/Independent on Sunday (O),2011-07-14,36,40,10,,,-4
YouGov/Sun,2011-07-14,36,43,9,,,-7
YouGov/Sun,2011-07-13,35,43,10,,,-8
YouGov/Sun,2011-07-12,37,42,9,,,-5
YouGov/Sun,2011-07-11,35,43,10,,,-8
YouGov/Sunday Times,2011-07-08,35,44,8,,,-9
YouGov/Sun,2011-07-07,37,43,8,,,-6
YouGov/Sun,2011-07-06,35,43,9,,,-8
YouGov/Sun,2011-07-05,35,43,10,,,-8
YouGov/Sun,2011-07-04,37,43,9,,,-6
YouGov/Sunday Times,2011-07-01,36,42,9,,,-6
YouGov/Sun,2011-06-30,37,42,8,,,-5
YouGov/Sun,2011-06-29,37,41,10,,,-4
YouGov/Sun,2011-06-28,36,43,8,,,-7
YouGov/Sun,2011-06-27,37,42,10,,,-5
ComRes/Independent,2011-06-26,36,40,11,,,-4
YouGov/Sunday Times,2011-06-24,36,43,9,,,-7
YouGov/Sun,2011-06-23,37,42,9,,,-5
YouGov/Sun,2011-06-22,36,42,9,,,-6
YouGov/Sun,2011-06-21,37,42,8,,,-5
YouGov/Sun,2011-06-20,37,43,9,,,-6
Ipsos-MORI/Reuters,2011-06-19,37,39,11,,,-2
ICM/Guardian,2011-06-19,37,39,12,,,-2
YouGov/Sunday Times,2011-06-17,37,42,10,,,-5
ComRes/Independent on Sunday (O),2011-06-16,37,37,11,,,0
YouGov/Sun,2011-06-16,37,43,9,,,-6
YouGov/Sun,2011-06-15,36,42,9,,,-6
YouGov/Sun,2011-06-14,37,42,10,,,-5
YouGov/Sun,2011-06-13,37,42,10,,,-5
Populus/Times,2011-06-12,39,40,9,,,-1
YouGov/Sunday Times,2011-06-10,37,42,9,,,-5
YouGov/Sun,2011-06-09,37,43,8,,,-6
YouGov/Sun,2011-06-08,37,42,9,,,-5
YouGov/Sun,2011-06-07,36,44,8,,,-8
YouGov/Sun,2011-06-06,37,43,9,,,-6
YouGov/Sunday Times,2011-06-03,37,42,9,,,-5
YouGov/Sun,2011-06-02,36,42,9,,,-6
YouGov/Sun,2011-06-01,39,41,9,,,-2
YouGov/Sun,2011-05-31,37,42,9,,,-5
ComRes/Independent,2011-05-29,37,37,12,,,0
YouGov/Sunday Times,2011-05-27,37,43,9,,,-6
YouGov/Sun,2011-05-26,37,43,8,,,-6
YouGov/Sun,2011-05-25,37,41,10,,,-4
Ipsos-MORI/Reuters,2011-05-24,35,42,10,,,-7
YouGov/Sun,2011-05-24,38,42,9,,,-4
YouGov/Sun,2011-05-23,38,42,10,,,-4
YouGov/Sunday Times,2011-05-20,37,42,8,,,-5
YouGov/Sun,2011-05-19,38,40,10,,,-2
YouGov/Sun,2011-05-18,36,42,9,,,-6
YouGov/Sun,2011-05-17,39,41,9,,,-2
YouGov/Sun,2011-05-16,38,41,10,,,-3
ComRes/Independent on Sunday (O),2011-05-15,38,39,11,,,-1
YouGov/Sunday Times,2011-05-13,36,41,9,,,-5
YouGov/Sun,2011-05-12,39,41,9,,,-2
YouGov/Sun,2011-05-11,36,42,8,,,-6
YouGov/Sun,2011-05-10,38,40,9,,,-2
YouGov/Sun,2011-05-09,38,42,8,,,-4
Opinium/,2011-05-09,35,38,9,,,-3
Populus/Times,2011-05-08,37,39,11,,,-2
YouGov/Sunday Times,2011-05-06,36,41,10,,,-5
YouGov/Sun,2011-05-05,37,39,10,,,-2
YouGov/Sun,2011-05-04,36,40,11,,,-4
ICM/Guardian,2011-05-03,36,37,15,,,-1
YouGov/Sun,2011-05-03,37,42,10,,,-5
Opinium/,2011-05-02,35,37,11,,,-2
ComRes/Independent,2011-05-01,34,37,15,,,-3
YouGov/Sunday Times,2011-04-29,36,41,10,,,-5
YouGov/Sun,2011-04-28,36,41,12,,,-5
YouGov/Sun,2011-04-27,36,42,10,,,-6
YouGov/Sun,2011-04-26,36,41,10,,,-5
YouGov/Sun,2011-04-21,36,42,10,,,-6
YouGov/Sun,2011-04-20,36,43,9,,,-7
YouGov/Sun,2011-04-19,36,43,9,,,-7
YouGov/Sun,2011-04-18,36,42,9,,,-6
Ipsos-MORI/Reuters,2011-04-17,40,40,9,,,0
ICM/Guardian,2011-04-17,35,37,15,,,-2
ComRes/Independent on Sunday (O),2011-04-15,35,39,10,,,-4
YouGov/Sunday Times,2011-04-15,37,41,9,,,-4
YouGov/Sun,2011-04-14,36,42,10,,,-6
YouGov/Sun,2011-04-13,35,44,10,,,-9
YouGov/Sun,2011-04-12,37,42,9,,,-5
YouGov/Sun,2011-04-11,36,42,10,,,-6
Populus/Times,2011-04-10,36,40,11,,,-4
Angus Reid/,2011-04-10,31,42,11,,,-11
YouGov/Sunday Times,2011-04-08,36,43,9,,,-7
YouGov/Sun,2011-04-07,35,44,10,,,-9
YouGov/Sun,2011-04-06,36,42,10,,,-6
YouGov/Sun,2011-04-05,37,42,9,,,-5
YouGov/Sun,2011-04-04,37,42,9,,,-5
YouGov/Sunday Times,2011-04-01,36,42,11,,,-6
YouGov/Sun,2011-03-31,35,42,10,,,-7
YouGov/Sun,2011-03-30,35,45,9,,,-10
YouGov/Sun,2011-03-29,36,42,10,,,-6
Opinium/,2011-03-28,34,37,11,,,-3
YouGov/Sun,2011-03-28,38,44,9,,,-6
ComRes/Independent,2011-03-27,35,41,13,,,-6
Opinium/,2011-03-25,36,36,11,,,0
YouGov/Sunday Times,2011-03-25,38,41,11,,,-3
ICM/Guardian,2011-03-24,37,36,16,,,1
YouGov/Sun,2011-03-24,37,41,11,,,-4
YouGov/Sun,2011-03-23,36,42,10,,,-6
YouGov/Sun,2011-03-22,35,42,9,,,-7
Opinium/,2011-03-21,36,36,11,,,0
YouGov/Sun,2011-03-21,36,43,9,,,-7
Angus Reid/,2011-03-21,32,41,10,,,-9
YouGov/Sunday Times,2011-03-18,37,43,9,,,-6
Opinium/,2011-03-17,35,39,11,,,-4
YouGov/Sun,2011-03-17,35,43,10,,,-8
YouGov/Sun,2011-03-16,35,43,10,,,-8
YouGov/Sun,2011-03-15,35,45,9,,,-10
YouGov/Sun,2011-03-14,35,44,9,,,-9
Ipsos-MORI/Reuters,2011-03-13,37,41,10,,,-4
YouGov/Sunday Times,2011-03-11,33,44,10,,,-11
ComRes/Independent on Sunday (O),2011-03-10,37,40,11,,,-3
YouGov/Sun,2011-03-10,34,45,9,,,-11
YouGov/Sun,2011-03-09,36,42,9,,,-6
YouGov/Sun,2011-03-08,36,44,10,,,-8
Opinium/,2011-03-07,36,39,9,,,-3
YouGov/Sun,2011-03-07,36,42,9,,,-6
Populus/Times,2011-03-06,35,41,11,,,-6
YouGov/Sunday Times,2011-03-04,35,43,10,,,-8
Angus Reid/,2011-03-04,33,41,10,,,-8
YouGov/Sun,2011-03-03,36,42,10,,,-6
YouGov/Sun,2011-03-02,36,41,11,,,-5
YouGov/Sun,2011-03-01,34,43,11,,,-9
YouGov/Sun,2011-02-28,36,43,10,,,-7
ComRes/Independent,2011-02-27,35,39,12,,,-4
YouGov/Sunday Times,2011-02-25,36,44,10,,,-8
Opinium/,2011-02-24,36,38,11,,,-2
YouGov/Sun,2011-02-24,38,42,10,,,-4
YouGov/Sun,2011-02-23,38,44,11,,,-6
YouGov/Sun,2011-02-22,37,43,9,,,-6
YouGov/Sun,2011-02-21,36,42,11,,,-6
ICM/Guardian,2011-02-20,35,38,18,,,-3
YouGov/Sunday Times,2011-02-18,37,41,10,,,-4
YouGov/Sun,2011-02-17,36,42,10,,,-6
YouGov/Sun,2011-02-16,35,45,10,,,-10
Opinium/,2011-02-15,35,36,12,,,-1
YouGov/Sun,2011-02-15,37,44,10,,,-7
YouGov/Sun,2011-02-14,36,44,10,,,-8
Ipsos-MORI/Reuters,2011-02-12,33,43,13,,,-10
YouGov/Sunday Times,2011-02-11,35,45,9,,,-10
ComRes/Independent on Sunday (O),2011-02-10,36,42,11,,,-6
Angus Reid/,2011-02-10,34,40,11,,,-5
YouGov/Sun,2011-02-10,35,44,10,,,-9
YouGov/Sun,2011-02-09,36,43,10,,,-7
Opinium/,2011-02-08,36,38,11,,,-2
YouGov/Sun,2011-02-08,35,43,10,,,-8
YouGov/Sun,2011-02-07,37,43,9,,,-6
Populus/Times,2011-02-06,36,39,11,,,-3
YouGov/Sunday Times,2011-02-04,36,42,10,,,-6
YouGov/Sun,2011-02-03,37,44,9,,,-7
YouGov/Sun,2011-02-02,36,44,9,,,-8
Opinium/,2011-02-02,35,40,11,,,-5
YouGov/Sun,2011-02-01,39,44,8,,,-5
YouGov/Sun,2011-01-31,40,42,8,,,-2
ComRes/Independent,2011-01-30,34,43,10,,,-9
Angus Reid/Sunday Express,2011-01-28,32,43,11,,,-11
YouGov/Sunday Times,2011-01-28,39,43,8,,,-4
YouGov/Sun,2011-01-27,38,44,8,,,-6
YouGov/Sun,2011-01-26,39,41,10,,,-2
Opinium/,2011-01-25,34,38,12,,,-4
YouGov/Sun,2011-01-25,37,43,10,,,-6
Angus Reid/,2011-01-25,33,41,12,,,-8
YouGov/Sun,2011-01-24,37,42,11,,,-5
Ipsos-MORI/Reuters,2011-01-24,33,43,13,,,-10
ICM/Guardian,2011-01-23,35,39,15,,,-4
YouGov/Sunday Times,2011-01-21,39,43,9,,,-4
YouGov/Sun,2011-01-20,36,43,10,,,-7
YouGov/Sun,2011-01-19,37,42,9,,,-5
YouGov/Sun,2011-01-18,39,44,8,,,-5
YouGov/Sun,2011-01-17,37,42,9,,,-5
Opinium/,2011-01-14,35,38,12,,,-3
YouGov/Sunday Times,2011-01-14,37,43,9,,,-6
ComRes/Independent on Sunday (O),2011-01-13,36,40,10,,,-4
YouGov/Sun,2011-01-13,41,41,8,,,0
YouGov/Sun,2011-01-12,36,43,9,,,-7
YouGov/Sun,2011-01-11,40,41,7,,,-1
YouGov/Sun,2011-01-10,40,43,8,,,-3
ComRes/Independent,2011-01-09,34,42,12,,,-8
YouGov/Sunday Times,2011-01-07,38,41,10,,,-3
Angus Reid/,2011-01-06,35,40,12,,,-5
YouGov/Sun,2011-01-06,39,43,7,,,-4
Opinium/,2011-01-05,37,39,11,,,-2
YouGov/Sun,2011-01-05,40,41,10,,,-1
YouGov/Sun,2011-01-04,40,42,8,,,-2
YouGov/Sun,2010-12-23,39,41,9,,,-2
YouGov/Sun,2010-12-22,41,42,8,,,-1
YouGov/Sun,2010-12-21,40,42,9,,,-2
Angus Reid/,2010-12-20,35,41,9,,,-6
YouGov/Sun,2010-12-20,40,43,8,,,-3
YouGov/Sunday Times,2010-12-19,39,42,9,,,-3
ICM/Guardian,2010-12-19,37,39,13,,,-2
Opinium/,2010-12-17,37,37,12,,,0
ComRes/Independent on Sunday (O),2010-12-16,37,39,11,,,-2
YouGov/Sun,2010-12-16,41,41,9,,,0
YouGov/Sun,2010-12-15,42,40,8,,,2
YouGov/Sun,2010-12-14,39,42,9,,,-3
YouGov/Sun,2010-12-13,41,42,9,,,-1
Ipsos-MORI/Reuters,2010-12-12,38,39,11,,,-1
Opinium/,2010-12-10,37,36,12,,,1
YouGov/Sunday Times,2010-12-10,40,42,9,,,-2
YouGov/Sun,2010-12-09,41,39,11,,,2
Opinium/,2010-12-08,38,37,11,,,1
YouGov/Sun,2010-12-08,41,41,8,,,0
YouGov/Sun,2010-12-07,42,39,9,,,3
YouGov/Sun,2010-12-06,42,39,10,,,3
YouGov/Sunday Times,2010-12-03,41,39,10,,,2
Opinium/,2010-12-02,38,34,13,,,4
YouGov/Sun,2010-12-02,40,40,11,,,0
YouGov/Sun,2010-12-01,41,38,11,,,3
YouGov/Sun,2010-11-30,40,40,10,,,0
Angus Reid/PoliticalBetting,2010-11-30,35,40,13,,,-5
YouGov/Sun,2010-11-29,40,40,10,,,0
ComRes/Independent,2010-11-29,36,40,12,,,-4
Opinium/,2010-11-26,37,35,14,,,2
YouGov/Sunday Times,2010-11-26,40,40,9,,,0
YouGov/Sun,2010-11-25,42,39,10,,,3
YouGov/Sun,2010-11-24,40,40,9,,,0
YouGov/Sun,2010-11-23,42,40,10,,,2
YouGov/Sun,2010-11-22,41,38,11,,,3
ICM/Guardian,2010-11-21,36,38,14,,,-2
ComRes/Independent on Sunday (O),2010-11-19,37,38,13,,,-1
YouGov/Sunday Times,2010-11-19,40,38,11,,,2
YouGov/Sun,2010-11-18,40,40,11,,,0
Opinium/,2010-11-17,38,34,13,,,4
YouGov/Sun,2010-11-17,40,40,11,,,0
YouGov/Sun,2010-11-16,37,42,10,,,-5
YouGov/Sun,2010-11-15,40,42,10,,,-2
Ipsos-MORI/Reuters,2010-11-14,36,39,14,,,-3
YouGov/Sunday Times,2010-11-12,39,41,10,,,-2
YouGov/Sun,2010-11-11,40,40,10,,,0
YouGov/Sun,2010-11-10,42,37,11,,,5
Opinium/,2010-11-09,39,33,14,,,6
YouGov/Sun,2010-11-09,40,39,13,,,1
YouGov/Sun,2010-11-08,42,39,11,,,3
YouGov/Sunday Times,2010-11-05,40,39,12,,,1
YouGov/Sun,2010-11-04,40,39,11,,,1
YouGov/Sun,2010-11-03,40,40,9,,,0
YouGov/Sun,2010-11-02,41,40,11,,,1
YouGov/Sun,2010-11-01,41,39,11,,,2
ComRes/Independent,2010-10-30,35,37,16,,,-2
Opinium/,2010-10-29,38,35,13,,,3
YouGov/Sunday Times,2010-10-29,42,37,13,,,5
Angus Reid/,2010-10-28,35,37,15,,,-2
YouGov/Sun,2010-10-28,41,39,11,,,2
YouGov/Sun,2010-10-27,41,39,12,,,2
YouGov/Sun,2010-10-26,40,38,12,,,2
YouGov/Sun,2010-10-25,40,40,11,,,0
Populus/Times,2010-10-24,37,38,15,,,-1
ICM/Guardian,2010-10-24,39,36,16,,,3
YouGov/Sunday Times,2010-10-22,41,40,10,,,1
ICM/News of the World,2010-10-22,40,36,16,,,4
YouGov/Sun,2010-10-21,41,40,10,,,1
YouGov/Sun,2010-10-20,41,39,11,,,2
YouGov/Sun,2010-10-19,42,39,11,,,3
YouGov/Sun,2010-10-18,41,39,12,,,2
Ipsos-MORI/Reuters,2010-10-17,39,36,14,,,3
YouGov/Sunday Times,2010-10-17,41,39,11,,,2
ComRes/Independent on Sunday (O),2010-10-15,40,34,14,,,6
YouGov/Sun,2010-10-14,42,38,12,,,4
YouGov/Sun,2010-10-13,41,40,11,,,1
YouGov/Sun,2010-10-12,43,36,12,,,7
YouGov/Sun,2010-10-11,42,38,12,,,4
YouGov/Sunday Times,2010-10-08,42,38,12,,,4
YouGov/Sun,2010-10-07,42,38,12,,,4
ICM/Sunday Telegraph,2010-10-07,38,34,18,,,4
YouGov/Sun,2010-10-06,42,40,11,,,2
YouGov/Sun,2010-10-05,43,39,11,,,4
YouGov/Sun,2010-10-04,41,39,12,,,2
ComRes/Independent (O),2010-10-01,39,36,15,,,3
Angus Reid/Sunday Express,2010-10-01,35,38,16,,,-3
BPIX/Mail on Sunday,2010-10-01,41,37,13,,,4
YouGov/Sunday Times,2010-10-01,39,41,11,,,-2
YouGov/Sun,2010-09-30,41,39,12,,,2
YouGov/Sun,2010-09-29,41,39,12,,,2
ICM/Guardian,2010-09-29,35,37,18,,,-2
YouGov/Sun,2010-09-28,41,40,12,,,1
YouGov/Sun,2010-09-27,39,40,12,,,-1
YouGov/Sunday Times,2010-09-24,39,38,15,,,1
YouGov/Sun,2010-09-23,41,37,13,,,4
YouGov/Sun,2010-09-22,43,36,14,,,7
YouGov/Sun,2010-09-21,39,39,13,,,0
YouGov/Sun,2010-09-20,42,38,11,,,4
Opinium/,2010-09-17,37,35,13,,,2
YouGov/Sunday Times,2010-09-17,41,39,13,,,2
ComRes/Independent on Sunday (O),2010-09-16,37,35,15,,,2
YouGov/Sun,2010-09-16,41,38,12,,,3
YouGov/Sun,2010-09-15,42,39,12,,,3
YouGov/Sun,2010-09-14,40,39,12,,,1
YouGov/Sun,2010-09-13,41,38,12,,,3
Ipsos-MORI/Reuters,2010-09-12,37,37,15,,,0
Populus/Times,2010-09-12,39,37,14,,,2
YouGov/Sunday Times,2010-09-10,42,38,14,,,4
YouGov/Sun,2010-09-09,42,37,14,,,5
YouGov/Sun,2010-09-08,43,38,12,,,5
YouGov/Sun,2010-09-07,42,38,13,,,4
YouGov/Sun,2010-09-06,42,37,13,,,5
ComRes/Independent,2010-09-05,38,34,18,,,4
YouGov/Sunday Times,2010-09-03,42,37,12,,,5
YouGov/Sun,2010-09-02,42,37,12,,,5
YouGov/Sun,2010-09-01,43,37,12,,,6
YouGov/Sun,2010-08-31,43,38,11,,,5
YouGov/Sunday Times,2010-08-27,41,37,13,,,4
YouGov/Sun,2010-08-26,42,37,12,,,5
YouGov/Sun,2010-08-25,42,37,12,,,5
YouGov/Sun,2010-08-24,41,38,13,,,3
YouGov/Sun,2010-08-23,41,39,12,,,2
YouGov/Sunday Times,2010-08-20,41,38,12,,,3
YouGov/Sun,2010-08-19,41,37,14,,,4
YouGov/Sun,2010-08-18,44,36,12,,,8
YouGov/Sun,2010-08-17,42,37,14,,,5
YouGov/Sun,2010-08-16,41,37,15,,,4
ComRes/Mirror/GMTV,2010-08-15,39,33,15,,,6
ICM/Guardian,2010-08-15,37,37,18,,,0
Harris/Daily Mail,2010-08-13,38,36,16,,,2
Opinium/,2010-08-13,39,30,16,,,9
YouGov/Sunday Times,2010-08-13,42,37,13,,,5
YouGov/Sun,2010-08-12,42,37,14,,,5
YouGov/Sun,2010-08-11,41,37,15,,,4
YouGov/Sun,2010-08-10,42,38,14,,,4
YouGov/Sun,2010-08-09,40,36,15,,,4
ComRes/Independent,2010-08-08,39,33,16,,,6
YouGov/Sunday Times,2010-08-06,42,36,13,,,6
YouGov/Sun,2010-08-05,44,36,13,,,8
YouGov/Sun,2010-08-04,42,36,13,,,6
YouGov/Sun,2010-08-03,41,36,13,,,5
YouGov/Sun,2010-08-02,42,38,12,,,6
YouGov/Sunday Times,2010-07-30,42,38,12,,,4
YouGov/Sun,2010-07-29,41,35,15,,,6
YouGov/Sun,2010-07-28,42,36,14,,,6
YouGov/Sun,2010-07-27,42,37,14,,,5
YouGov/Sun,2010-07-26,42,35,15,,,7
ICM/Guardian,2010-07-25,38,34,19,,,4
Ipsos-MORI/Reuters,2010-07-25,40,38,14,,,2
YouGov/Sunday Times,2010-07-23,41,36,14,,,5
YouGov/Sun,2010-07-22,43,35,15,,,8
YouGov/Sun,2010-07-21,44,35,13,,,9
YouGov/Sun,2010-07-20,43,35,14,,,8
YouGov/Sun,2010-07-19,42,35,15,,,7
YouGov/Sunday Times,2010-07-16,40,37,15,,,3
YouGov/Sun,2010-07-15,43,34,15,,,9
YouGov/Sun,2010-07-14,43,34,15,,,9
YouGov/Sun,2010-07-13,42,35,15,,,7
YouGov/Sun,2010-07-12,42,35,15,,,7
Opinium/,2010-07-09,38,34,16,,,4
YouGov/Sunday Times,2010-07-09,42,34,17,,,6
YouGov/Sun,2010-07-08,42,35,16,,,7
YouGov/Sun,2010-07-07,40,36,17,,,4
YouGov/Sun,2010-07-06,41,36,15,,,5
YouGov/Sun,2010-07-05,40,36,16,,,4
Opinium/,2010-07-02,37,33,18,,,4
YouGov/Sunday Times,2010-07-02,41,36,16,,,5
YouGov/Sun,2010-07-01,42,35,16,,,7
YouGov/Sun,2010-06-30,42,36,15,,,6
YouGov/Sun,2010-06-29,42,36,15,,,6
YouGov/Sun,2010-06-28,42,35,16,,,7
ComRes/Independent,2010-06-27,40,31,18,,,9
YouGov/Sunday Times,2010-06-25,43,36,16,,,7
ICM/Sunday Telegraph,2010-06-24,41,35,16,,,6
YouGov/Sun,2010-06-24,43,34,17,,,9
Populus/Times,2010-06-23,39,33,18,,,6
YouGov/Sun,2010-06-23,42,34,17,,,8
YouGov/Sun,2010-06-22,41,37,15,,,4
YouGov/Sun,2010-06-21,41,33,18,,,8
Ipsos-MORI/Reuters,2010-06-20,39,31,19,,,8
ICM/Guardian,2010-06-20,39,31,21,,,8
Opinium/,2010-06-18,40,31,19,,,9
YouGov/Sunday Times,2010-06-18,39,34,19,,,5
ComRes/Independent on Sunday,2010-06-17,36,30,23,,,6
YouGov/Sunday Times,2010-06-11,40,32,18,,,8
BPIX/Mail on Sunday,2010-06-11,39,32,19,,,7
Harris/Metro,2010-06-09,36,30,25,,,6
Opinium/,2010-06-04,42,28,19,,,14
ComRes/Independent,2010-05-31,37,33,21,,,4
ICM/Guardian,2010-05-23,39,32,21,,,7
Opinium/,2010-05-21,38,29,21,,,9
YouGov/Sunday Times,2010-05-21,39,32,21,,,7
YouGov/Sunday Times,2010-05-14,37,34,21,,,3
ComRes/Independent on Sunday/S. Mirror,2010-05-13,38,34,21,,,4
ICM/Sunday Telegraph,2010-05-13,38,33,21,,,5
